vāgarthāviva sampṛktau vāgarthapratipattaye / jagataḥ pitarau vande pārvatīparameśvarau // Ragh(K)_1.1 //	SFor the right comprehension of words and their senses, I salute Pârvati (the mountain's daughter) and Parames'vara (the supreme lord) the parents of the universe, who are (perpetually) united like words and their meanings.
kva sūryaprabhavo vaṃśaḥ kva cālpaviṣayā matiḥ / titīrṣurdustaraṃ mohāduḍupenāsmi sāgaram // Ragh(K)_1.2 //	The (exalted) race sprung from the sun, and my intellect of limited scope (to describe it),-how unequal the two! It is under a delusion that I am desirous of crossing, by means of a raft, the ocean, so difficult to be crossed.
prāṃśulabhye phale lobhādudbāhuriva vāmanaḥ // Ragh(K)_1.3 //	Dull (of intellect) and yet aspiring after a poet's fame, I shall expose myself to ridicule, like a dwarf, who, through greed, uplifts his hands for a fruit accessible (only) to the tall.
athavā kṛtavāgdvāre vaṃśe 'sminpūrvasūribhiḥ / maṇau vajrasamutkīrṇe sūtrasyevāsti me gatiḥ // Ragh(K)_1.4 //	Or rather, I shall find entrance into this race (I may enter upon the task of describing this line of kings), to which the door of description has already been opened by poets of yore, as does a thread into a gem previously perforated by a diamond-pin.
āsamudrakṣitīśānāmānākarathavartmanām // Ragh(K)_1.5 // yathāvidhihutāgnīnāṃ yathākāmārcitārthinām / yathāparādhadaṇḍānāṃ yathākālaprabodhinām // Ragh(K)_1.6 // tyāgāya sambhṛtārthānāṃ satyāya mitabhāṣiṇām / yaśase vijigīṣūṇāṃ prajāyai gṛhamedhinām // Ragh(K)_1.7 //	I, who am such, will describe the line of the Raghus, though my powers of expression are scanty, being impelled to this inconsiderate act by their (transcendental) virtues coming to my ears: the Raghus, who were pure from birth, who persevered in works until they bore fruit, who were lords of the earth bounded by the ocean, and the track of whose cars lay as far as the celestial regions (9, 5); who offered oblations to the holy fires in accord- ance with the prescribed rules, who honoured supplicants (by gifts) according to their desires, who inflicted punishment in proportion to the crime, and who (woke up, or) were on the alert at the proper time (6); who amassed wealth for giving it away in charity, who spoke sparingly for the sake of truthfulness, who were desirous of conquest for fame (alone), and who consorted with their wives solely for the sake of offspring (7); who (again) spent thei: boyhood in the study of letters, who enjoyed pleasures in their youth, who led an anchorite's life in their old age, and who finally resigned their bodies by means of yoga (i.e. fixing their min ds in meditation upon the supreme spirit).
taṃ santaḥ śrotumarhanti sadasadvyaktihetavaḥ / hemnaḥ saṃlakṣyate hyagnau viśuddhiḥ śyāmikāpi vā // Ragh(K)_1.10 //	It behoves the learned who alone can discriminate what is good from what is bad (lit. who are the causes of the distinction.; of (2) between good and bad) to listen to this (poem); for it is in fire alone that the purity or alloy of gold is tested.
vaivasvato manurnāma mānanīyo manīṣiṇām /	There was a king, by name Manu, the son of Vivasvat, esteemed by the wise, who was the first of kings, as the sacred syllble Om is of the Vedas.
tadanvaye śuddhimati prasūtaḥ śuddhimattaraḥ /	In this pure race was born a purer king, Dilipa by name, a supremely eminent monarch, just as the purer moon arose from the pure milky ocean.
vyūḍhorasko vṛṣaskandhaḥ sālaprāṃśurmahābhujaḥ / ātmakarmakṣamaṃ dehaṃ kṣātro dharma ivāśritaḥ // Ragh(K)_1.13 //	Broad-chested, stout-shouldered (lit. having shoulders like those of a bull), tall as the s'a'la tree, and massive-armed, he looked like the military virtue (heroism) appearing in a corporeal frame fitted for the discharge of its duties.
sthitaḥ sarvonnatenorvīṃ krāntvā merurivātmanā // Ragh(K)_1.14 //	Like the mountain Meru, he stood occupying (dominating) the whole earth, with a frame that exceeded all in strength, outshone all in lustre and transcended all in majesty.
ākārasadṛśaprajñaḥ prajñayā sadṛśāgamaḥ /	His intellect was commensurate with his bodily form, his knowledge with his intelligence, his undertakings with his knowledge, and his success with his undertakings.
bhīmakāntairnṛpaguṇaiḥ sa babhūvopajīvinām / adhṛṣyaścābhigamyaśca yādoratnairivārṇavaḥ // Ragh(K)_1.16 //	By his kingly virtues which were both awe-inspiring and amiable he was to his subjects, at once unapproachable and invit- ing, just as the ocean is on account of its monsters and gems.
rekhāmātramapi kṣuṇṇādātmano vartmanaḥ param / na vyatīyuḥ prajāstasya niyanturnemivṛttayaḥ // Ragh(K)_1.17 //	Acting like the rim of a wheel under a skilful driver, the subjects of him, their guide, swerved not even to the width of a line from the path that had been trodden from the days of Manu 18.
sahasraguṇamutsraṣṭumādatte hi rasaṃ raviḥ // Ragh(K)_1.18 //	He received taxes from his subjects only for the promotion of their welfare: for the sun sucks up water simply to give it back a thousand-fold (in the shape of rain).
senā paricchadastasya dvayamevārthasādhanam / śāstre ca vyāpṛtā buddhirmaurvī dhanuṣi cātatā // Ragh(K)_1.19 //	His army was but an appendage to him; his means of accomplishing his objects were only twofold-an intelligence that was unfoiled in (penetrated) the branches of learning, and the string stretched out on the bow.
phalānumeyāḥ prārambhāḥ saṃskārāḥ prāktanā iva // Ragh(K)_1.20 //	His counsels being secret and his countenance and designs inscrutable, his measures, like the impressions (left on the mind by the good or evil deeds) of a prior existence, were to be inferred only from their results.
jugopātmānamatrasto bheje dharmamanāturaḥ / agṛdhnurādade so 'rthānasaktaḥ sukhamanvabhūt // Ragh(K)_1.21 //	(Though) without fear, he protected his body; unafflicted with disease he performed religious rites; unavaricious he amassed wealth; and unaddicted he enjoyed pleasures.१०६ ( 3 ) 22.
jñāne maunaṃ kṣamā śaktau tyāge ślāghāviparyayaḥ / guṇā guṇānubandhitvāttasya saprasavā iva // Ragh(K)_1.22 //	His modest reserve, notwithstanding his knowledge; for- bearance, in spite of power; and absence of boasting, in the presence of beneficence; thus virtues, from their association in him with others (of opposite nature), were, as it were, like brothers born of the same womb (linked in a tie of brotherhood), 23.
anākṛṣṭasya viṣayairvidyānāṃ pāradṛśvanaḥ / tasya dharmaraterāsīdvṛddhatvaṃ jarasā vinā // Ragh(K)_1.23 //	He, who was not attracted by carnal pleasures, who had seen the very end of (mastered) the branches of knowledge, and who took delight in the discharge of his duty, had all the perfec- tion of old age without being (actually) aged.
sa pitā pitarastāsāṃ kevalaṃ janmahetavaḥ // Ragh(K)_1.24 //	By reason of his educating, Protecting, and maintaining his subjects, he was (virtually) their father; their (real) fathers were merely the source of their birth.
apyarthakāmau tasyāstāṃ dharma eva manīṣiṇaḥ // Ragh(K)_1.25 //	He punished criminals for the preservation of order, and had married only for progeny, so that, even his pursuit of wealth and sensual pleasures was simply the (pursuit of) Dharma (the performance of duty).
dudoha gāṃ sa yajñāya sasyāya maghavā divam / sampadvinimayenobhau dadhaturbhuvanadvayam // Ragh(K)_1.26 //	He drained (collected tributes from ) the earth for the performance of sacrifices, and Indra drained the heavens for (the growth of) crops; thus by an exchange of their wealth the two sustained the twin worlds.
na kilānuyayustasya rājāno rakṣituryaśaḥ /	Other kings, indeed, could not attain his fame for protect- ing people; for (the crime of) theft having turned away from men's property, survived only in the term (expressive of theft).
tyājyo duṣṭaḥ priyo 'pyāsīddaṣṭo 'ṅguṣṭha ivāhinā // Ragh(K)_1.28 //	A good man, though unfriendly, was acceptable to him, just as (though distasteful) medicine is to the sick; and even a friend, if wicked, was to be discarded, like a finger bitten by a cobra.
tathā hi sarve tasyāsanparārthaikaphalā guṇāḥ // Ragh(K)_1.29 //	Verily the Creator fashioned him with the ingredients of the five great elements; for all his qualities had solely the good of others (for their object).
sa velāvapravalayāṃ parikhīkṛtasāgarām / ananyaśāsanāmurvīṃ śaśāsaikapurīmiva // Ragh(K)_1.30 //	He governed the earth as if it were a single city, having the shores of the seas for its line of ramparts and the seas them- selves for its moats, and owning no other rule.
tasya dākṣiṇyarūḍhena nāmnā māgadhavaṃśajā / patnī sudakṣiṇetyāsīdadhvarasyeva dakṣiṇā // Ragh(K)_1.31 //	He had a wife, like Dakshinâ of Yajña, a princess of the royal line of the Magadhas, by name Sudakshinâ, a name grown out of her amiability (or generosity, benignity).
kalatravantamātmānamavarodhe mahatyapi /	He, the lord of the earth, though he had a large harem regarded himself as having a wife by her, a high-minded lady, and by the goddess of royal fortune.(4) 33.
tasyāmātmānurūpāyāmātmajanmasamutsukaḥ / vilambitaphalaiḥ kālaṃ sa nināya manorathaiḥ // Ragh(K)_1.33 //	(Ever) longing for the birth of a son from her, his worthy consort, he passed his days in hopes, the realization of which was long delayed.
īpsatā santatiṃ nyastā tena mantriṣu kosalā // Ragh(K)_1.34 // athābhyarcya vidhātāraṃ prayatau putrakāmyayā / tau dampatī vasiṣṭhasya gurorjagmaturāśramam // Ragh(K)_1.35 //	With a view to perform some religious rite that he might obtain a son, he took down from his arms the heavy yoke of the world (withdrew himself from the heavy task of governing the world) and entrusted it to his ministers. Then being purified, the two, husband and wife, worship- ped the Creator of the world with the desire of obtaining a son, and then started for the hermitage of Vasishtha, their spiritual guide.
snigdhagambhīranirghoṣamekaṃ syandanamāśritau / prāvṛṣeṇyaṃ payovāhaṃ vidyudairāvatāviva // Ragh(K)_1.36 //	They drove in a single chariot which made a deep but agreeable sound, and (therefore) looked like lightning and Airàvata riding a cloud of the rainy season.
mā bhūdāśramapīḍeti parimeyapuraḥsarau /	That there should be no disturbance to the hermritage, they took a limited retinue with them; but on account of their peculiar majesty they looked as if they were surrounded by an army.
sevyamānau sukhasparśaiḥ sālaniryāsagandhibhiḥ / puṣpareṇūtkirairvātairādhūtavanarājibhiḥ // Ragh(K)_1.38 //	They were fanned (as they passed on) by breezes of a pleasant touch, wafting the odour of the exudations of the S'a'la trees, scattering about the pollen of flowers, and gently shaking the rows of the forest trees.
manobhirāmāḥ śṛṇvantau rathanemisvanonmukhaiḥ / ṣaḍjasaṃvādinīḥ kekā dvidhā bhinnāḥ śikhaṇḍibhiḥ // Ragh(K)_1.42 //	They listened to the notes, delightful to the mind, of pea- cocks that raised their necks at (on hearing) the rumbling of the wheels of the chariot, notes of a double kind and corresponding (in pitch) to the Shadja air.
parasparākṣisādṛśyamadūrojjhitavartmasu / mṛgadvandveṣu paśyantau syandanābaddhadṛṣṭiṣu // Ragh(K)_1.43 //	They observed the similarity of each other's eyes in those of the couples of deer, that moved a little out of the way and had their eyes riveted on the gliding car. Occasionally they raised their beads (attracted) by the cranes uttering sweet notes, and forming, as it were, as they flew in a row, a gateway- garland unsupported by posts.
śreṇibandhādvitanvadbhirastambhāṃ toraṇasrajam /	On account of the favourableness of the wind betokening the fulfilment of their wish, the tresses of the queen and the turban of the king were not touched by the dust raised by the horses.
sārasaiḥ kalanirhrādaiḥ kvacidunnamitānanau // Ragh(K)_1.44 //	They smelt the highly-pleasing fragrance of the lotuses in the tanks, cool by its coming in close contact with the ripples and imitating (the fragrance of) their breath.
grāmeṣvātmanisṛṣṭeṣu yūpacihneṣu yajvanām / amoghāḥ pratigṛhṇantāvarghyānupadamāśiṣaḥ // Ragh(K)_1.45 //	In the villages granted by themselves and marked with the sacrificial posts, they accepted, after they had received the( 5 ) offerings of honour, the unfailing benedictions of the sacrificers (Bráhmaṇas who properly performed the sacrificial rites.) 45. They inquired of the aged cowherds, that came to them with fresh butter, the names of the wild trees by the road-side.
kāpyabhikhyā tayorāsīdvrajatoḥ śuddhaveśayoḥ / himanirmuktayoryoge citrācandramasoriva // Ragh(K)_1.46 //	As they journeyed on, clad in bright apparel, an indescriba- ble beauty was visible in them, like that in the conjunction of the constellation Chitra' with the moon, when freed from the mists of winter.
tattadbhūmipatiḥ patnyai darśayanpriyadarśanaḥ / api laṅghitamadhvānaṃ bubudhe na budhopamaḥ // Ragh(K)_1.47 //	Engaged in showing this thing and that thing (i.e. the various curiosities of the road) to his spouse, the lord of the earth, of amiable appearance and worthy to be compared with Budha, was not even aware of the whole distance travelled over.
sāyaṃ saṃyaminastasya maharṣermahiṣīsakhaḥ // Ragh(K)_1.48 //	He (the king,) of a fame unattainable (by any one eise) and having the queen for his companion, reached, at dusk, with his steeds fatigued, the hermitage of the mighty sage who always practised self-control.
āśvāsāya vihaṅgānāmālavālāmbupāyinām // Ragh(K)_1.50 // ātapāpāyasaṅkṣiptanīvārāsu niṣādibhiḥ / mṛgairvartitaromanthamuṭajāṅganabhūmiṣu // Ragh(K)_1.51 // ākīrṇamṛṣipatnīnāmuṭajadvārarodhibhiḥ / apatyairiva nīvārabhāgadheyocitairmṛgaiḥ // Ragh(K)_1.52 //	(The hermitage) which was (then) being filled by ancho- rites returning from other forests bringing with them sacrificial sticks, holy grass, and fruits, and welcomed back by the sacred fires advancing forward in an invisible form; 50.-which was being crowded with deer accustomed to receive a share of the niva'ra corn (wild rice) and blocking up the doors of the huts, as if they were the children of the wives of the hermits; 51.-wherein the saplings were quitted by the hermits' daughters immediately after the watering was over, in order to inspire confi- dence in the birds accustomed to drink water from the basins round the roots of the trees; 52.-where the antelopes were chewing the cud, squatting in the courtyards of the huts in which wild rice had been collected into heaps, at the decline of the evening sunshine.
abhyuddhṛtāgnipiśunairatithīnāśramonmukhān / punānaṃ pavanoddhūtairdhūmairāhutigandhibhiḥ // Ragh(K)_1.53 //	which was purifying the casual visitors coming towards it by the columns of smoke, indicating the blazing of fires, shaken up by the wind and charged with the odour of the offerings.
atha yantāramādiśya dhuryānviśramayeti saḥ / tāmavārohayatpatnīṃ rathādavaruroha ca // Ragh(K)_1.54 //	Then having ordered the charioteer to give rest to the horses, the king assisted his wife to alight from the car and him- self also got down.
tasmai sabhyāḥ sabhāryāya goptre guptatamendriyāḥ / arhaṇāmarhate cakrurmunayo nayacakṣuṣe // Ragh(K)_1.55 //	The hospitable saints, with their senses perfectly controlled, gave an honourable welcome to him, their worthy protector,(6) who was guided by the principles of justice, and to his roya! consort.
vidheḥ sāyantanasyānte sa dadarśa taponidhim / anvāsitamarundhatyā svāhayeva havirbhujam // Ragh(K)_1.56 //	When the evening rites were over, the King saw the treasure of penance (Vasishtha) with Arundhatî seated behind him, like the god of fire with the goddess Sva' ha' sitting behind.
tayorjagṛhatuḥ pādau rājā rājñī ca māgadhī / tau gururgurupatnī ca prītyā pratinanandatuḥ // Ragh(K)_1.57 //	The king and the queen, the princess of Magadha, seized (touched) their feet in adoration, and the spiritual guide and his wedded spouse greeted (blessed) them with affection in return.
ātitheyastamātithyavinītādhvapariśramam / papraccha kuśalaṃ rājye rājyāśramamuniṃ muniḥ // Ragh(K)_1.58 //	The sage asked him, who was a hermit in the hermitage of a kingdom, and whose fatigue cansed by the jolting of the car had been removed by the act of hospitality, whether all was right with his kingdom.
athātharvanidhestasya vijitāripuraḥ puraḥ / arthyāmarthapatirvācamādade vadatāṃ varaḥ // Ragh(K)_1.59 //	Then, before the sage, the repository of the Atharva-lore, he, the lord of wealth, who had conquered the cities of the enemies, and was foremost among eloquent men, began (entered upon) a speech full of sense.
upapannaṃ nanu śivaṃ saptasvaṅgeṣu yasya me /	"Proper, indeed, it is that welfare should reign in all the seven elements of my state, of whose God-sent and man-caused calamities you are the averter.
pratyādiśyanta iva me dṛṣṭalakṣyabhidaḥ śarāḥ // Ragh(K)_1.61 //	My arrows which can hit only a visible mark, are, as it were, rendered futile by the spells, which discomfit enemies from a distance (even before they are seen), of you the author of incanta- tions.
havirāvarjitaṃ hotastvayā vidhivadagniṣu / vṛṣṭībhavati sasyānāmavagrahaviśoṣiṇām // Ragh(K)_1.62 //	O sacrificer, the oblation duly offered by you to the holy fires turns itself into rain for nourishing the crops, which, else, would wither by drought.
puruṣāyuṣajīvinyo nirātaṅkā nirītayaḥ / yanmadīyāḥ prajāstatra hetustvadbrahmavarcasam // Ragh(K)_1.63 //	That my subjects live the full period of human life, that they are free from fears, and are never visited by public calamities, is all due to (the virtue of) your spiritual power.
tadevaṃ cintyamānasya guruṇā brahmayoninā / sānubandhāḥ kathaṃ na syuḥ sampado me nirāpadaḥ // Ragh(K)_1.64 //	When I am thus taken care of by you, my preceptor, the son of Brahman, and so am free from calamities, why should not my prosperity be uninterrupted ? 65.
kiṃ tu vadhvāṃ tavaitasyāmadṛṣṭasadṛśaprajam / na māmavati sadvīpā ratnasūrapi medinī // Ragh(K)_1.65 //	But, even the (sovereignty of the whole) earth, with all its islands, though the yielder of the precious products, does not please me, who have not seen a worthy offspring born of this your daughter-in-law.
matparaṃ durlabhaṃ matvā nūnamāvarjitaṃ mayā / payaḥ pūrve svaniḥśvāsakaduṣṇamupabhuñjate // Ragh(K)_1.66 //	Verily the libation of water, offered by me, is drunk, rendered lukewarm with their sighs, by my forefathers, thinking that it would be difficult to be obtained after my death.
so 'hamijyāviśuddhātmā prajālopanimīlitaḥ / prakāśaścāndhakāraśca lokāloka ivācalaḥ // Ragh(K)_1.67 //	I, therefore, with my soul purified by the performance of sacrifices, but obscured by want of issue, am both shining and not shining like the mountain Loka loka (which is lighted on one side and dark on the other).
lokāntarasukhaṃ puṇyaṃ tapodānasamudbhavam / santatiḥ śuddhavaṃśyā tu paratreha ca śarmaṇe // Ragh(K)_1.68 //	Religious merit, resulting from the performance of penance and acts of charity, produces happiness in the next world; but off- spring, of pure extraction, leads to bliss in the next, as also in this world.
tayā hīnaṃ vinetā māṃ kathaṃ paśyanna dūyate /	How is it, O mighty sage, that you are not grieved to see. me destitute of the same, like a sapling of the hermitage, watered personally through affection, bearing no fruit ? 71.
asahyapīḍaṃ bhagavannṛṇabandhamavaihi me / aruntudamivālānaṃ navabaddhasya dantinaḥ // Ragh(K)_1.70 //	Know then, O mighty one, that the last debt has been causing me unendurable pain, as the tie-post piercing the vitals, does to an elephant, deprived of the bath.
ikṣvākūṇāṃ durāpe 'rthe tvadadhīnā hi siddhayaḥ // Ragh(K)_1.71 //	It behoves you, O father, to do that by which I may be released from it; for when an object is difficult of attainment to the descendants of Ikshváku, the success depends upon you." 73.
iti vijñāpito rājñā dhyānastimitalocanaḥ / kṣaṇamātramṛṣistasthau suptamīna iva hradaḥ // Ragh(K)_1.72 //	Thus respectfully informed by the king, the saint remained for a moment, with his eyes fixed in meditation, like a tank, with its fish asleep.
bhāvitātmā bhuvo bharturathainaṃ pratyabodhayat // Ragh(K)_1.73 //	He whose soul was purified by ascetic exercises, discover- ed by meditation the cause of the stoppoge of issue to the lord of the earth and then informed him thus:- - 75.
purā śakramupasthāya tavorvīṃ pratiyāsyataḥ / āsītkalpatarucchāyāsevinī surabhiḥ pathi // Ragh(K)_1.74 //	"On a former occasion, when you were returning to the earth, having waited upon Indra, Surabhi (the divine cow) was reposing under the shade of a Kalpa-(desire-granting) tree on your way.
imāṃ devīmṛtusnātāṃ smṛtvā sapadi satvaraḥ / pradakṣiṇakriyātītastasyāḥ kopamajījanaḥ // Ragh(K)_1.75 //	Full of thoughts of this your queen, bathed after menstrua- tion, being afraid to violate a sacred obligation (to her), you did not act properly towards her who deserved the honour (lit. act) of circumambulation.
avajānāsi māṃ yasmādataste na bhaviṣyati /	(And) she cursed you thus :-'Since you have shown disrespect to me, no progeny shall be born to you unless you propitiate my daughter.' 78.
sa śāpo na tvayā rājanna ca sārathinā śrutaḥ / nadatyākāśagaṅgāyāḥ srotasyuddāmadiggaje // Ragh(K)_1.77 //	Neither by you, nor by your charioteer, was the impreca- tion heard (being pronounced), as the stream of the Celestia!(8) Ganges was then in tumultuous uproar on account of the elephants of the quarters sporting wantonly in it.
pratibadhnāti hi śreyaḥ pūjyapūjāvyatikramaḥ // Ragh(K)_1.78 //	Know, then, that the attainment of your desire is barred by (that disrespect towards the cow); for omisssion of honour to those worthy of honour obstructs one's welfare.
haviṣe dīrghasattrasya sā cedānīṃ pracetasaḥ / bhujaṅgapihitadvāraṃ pātālamadhitiṣṭhati // Ragh(K)_1.79 //	That heavenly cow, however, is at present dwelling in the nether regions, the gates of which are blocked up (guarded) by serpents, for the supply of oblations in the prolonged sacrificial session which Varuna has instituted.
sa tvamekāntarāṃ tasyā madīyāṃ vatsamātaram / ārādhaya sapatnīkaḥ sā vāṃ kāmaṃ pradāsyati // Ragh(K)_1.80 //	Do you then take the daughter of Surabhi as her representative, and with your wife, propitiate her in a state of purity; for she, when pleased, is a milker of (gratifies) desires." 82.
iti vādina evāsya hoturāhutisādhanam / anindyā nandinī nāma dhenurāvavṛte vanāt // Ragh(K)_1.81 //	Just as he was speaking thus there came back from the forest the cow, Nandinf by name, blameless and the source (provider) of oblations to that habitual sacrificer.
sandhyā prātipadeneva vyatibhinnā himāṃśunā // Ragh(K)_1.82 // bhuvaṃ koṣṇena kuṇḍodhnī medhyenāvabhṛthādapi /	Of a soft pink colour, like a (new) leaf, and bearing a slightly-curved mark of white hair ( appearing on her forehead ), just as the evening-sky (pale-red like the young shoot), bears the crescent of the new moon.
prasnavenābhivarṣantī vatsālokapravartinā // Ragh(K)_1.83 // rajaḥkaṇaiḥ khuroddhūtaiḥ spṛśadbhirgātramantikāt / tīrthābhiṣekajāṃ śuddhimādadhānā mahīkṣitaḥ // Ragh(K)_1.84 //	With a large udder, and drenching the earth with a stream of tepid milk, which flowed at the sight of her calf and which was more sanctifying than even the ablution performed at the conclusion of a sacrifice. Imparting to the king the sanctity that arises from ablutions in a holy stream, by means of the particles of dust raised by her hoofs and coming from near in contact with his body.
tāṃ puṇyadarśanāṃ dṛṣṭvā nimittajñastapodhanaḥ / yājyamāśaṃsitāvandhyaprārthanaṃ punarabravīt // Ragh(K)_1.85 //	Seeing her of holy appearance, the receptacle of ascetism (the sage), versed in reading omens, again addressed him (the king), whose officiating priest he was, and whose desire to gain his object was not to be barren (was sure to be fulfilled ).
adūravartinīṃ siddhiṃ rājanvigaṇayātmanaḥ / upasthiteyaṃ kalyāṇī nāmni kīrtita eva yat // Ragh(K)_1.86 //	"Know for certain, O king, that the fulfilment of your wish is not far distant, since this blessed one has turned up the very moment her name was mentioned.
vanyavṛttirimāṃ śaśvadātmānugamanena gām / vidyāmabhyasaneneva prasādayitumarhasi // Ragh(K)_1.87 //	It behoves you therefore) to propitiate this cow by unceasing attendance upon her, and living npon the products of the forest, just as one does (gains) knowledge by close application.
prasthitāyāṃ pratiṣṭhethāḥ sthitāyāṃ sthānamācareḥ /	You should move on when she moves on, stand when she stands, sit down when she does so, and drink water when she has done the same.(9) 90.
prayātāṃ prātaranvetu sāyaṃ pratyudvrajedapi // Ragh(K)_1.89 // ityā prasādādasyāstvaṃ paricaryāparo bhava /	And let this our daughter-in-law too, being pure and full of devotion, follow her, after she is worshipped, in the morning, as far as the bounds of the penance-grove, and also advance thither in the evening to receive her.
avighnamastu te stheyāḥ piteva dhuri putriṇām // Ragh(K)_1.90 //	Thus be devoted to her service, until she is propitiated; may no obstruction overtake you; may you stand, like your father, at the head of those who are blessed with worthy sons!" 92.
ādeśaṃ deśakālajñaḥ śiṣyaḥ śāsiturānataḥ // Ragh(K)_1.91 //	The disciple ( of the sage, ) who knew the proper place and time, bowing accepted, in a pleased mood, with his queen, the command of his spiritual instructor, saying, "I will do so.
atha pradoṣe doṣajñaḥ saṃveśāya viśāṃ patim / sūnuḥ sūnṛtavāksraṣṭurvisasarjorjitaśriyam // Ragh(K)_1.92 //	Then at night, the learned son of the Creator, who always spoke agreeable and truthful words, dismissed the king, of dis- tinguished fortune (or of blazing radiance) to retire to bed.
satyāmapi tapaḥsiddhau niyamāpekṣayā muniḥ / kalpavitkalpayāmāsa vanyāmevāsya saṃvidhām // Ragh(K)_1.93 //	Although possessed of the superhuman power due to ripe asceticism, the sage, learned in ritual, having regard for the vow (undertaken by the king), provided him with such accommodation as was suited to a forest life.
nirdiṣṭāṃ kulapatinā sa parṇaśālāmadhyāsya prayataparigrahadvitīyaḥ / tacchiṣyādhyayananiveditāvasānāṃ saṃviṣṭaḥ kuśaśayane niśāṃ nināya // Ragh(K)_1.94 //	The king, accompanied by his wife free from pollution, occupied a hut pointed out by the kulapati, and ( there ) lying on a bed of Kus'a grass passed the night, the close of which was announced by the sage's disciples, chanting (aloud) the Veda.
atha prajānāmadhipaḥ prabhāte jāyāpratigrāhitagandhamālyām / vanāya pītapratibaddhavatsāṃ yaśodhano dhenumṛṣermumoca // Ragh(K)_2.1 //	Then at dawn, the lord of men, to whom his fame was a treasure, set free for ( going out to) the forest the cow of the sage whose calf had been tied up after it had its suck and who was made to accept sandal, garlands of flowers &c. (by him) through his wife.
mārgaṃ manuṣyeśvaradharmapatnī śruterivārthaṃ smṛtiranvagacchat // Ragh(K)_2.2 //	The lawful wife of the lord of men, worthy of being named at the head of chaste ladies, followed the path of the cow, the dust whereof was consecrated by the plantings of her hoofs, as (closely .as) Smriti (remembered law) follows the sense of S'ruti.
nivartya rājā dayitāṃ dayālustāṃ saurabheyīṃ surabhiryaśobhiḥ / payodharībhūtacatuḥsamudrāṃ jugopa gorūpadharāmivorvīm // Ragh(K)_2.3 //	The kind-hearted monarch, lovely with glory, having asked his beloved spouse to return, (himself) began to guard the daugh- ter of Surabhi, whose milk exceeded in quantity the waters of the four seas, as if he was protecting the earth itself, tranformed into a cow, with the four oceans turned into four teats.
na cānyatastasya śarīrarakṣā svavīryaguptā hi manoḥ prasūtiḥ // Ragh(K)_2.4 //	By him following the cow as a vow, the rest of his retinue too was sent back; the protection of his body was not due to an 2( 10 ) external source: for Manu's descendants were ever protected by their own valour.
āsvādavadbhiḥ kavalaistṛṇānāṃ kaṇḍūyanairdaṃśanivāraṇaiśca /	By (giving her) savoury mouthfuls of grass, by scratchings,.
sthitaḥ sthitāmuccalitaḥ prayātāṃ niṣeduṣīmāsanabandhadhīraḥ / jalābhilāṣī jalamādadānāṃ chāyeva tāṃ bhūpatiranvagacchat // Ragh(K)_2.6 //	by keeping off flies, and by uuobstructed rovings at will, thus did the supreme monarch become diligently engaged in her pro- pitiation. The lord of the earth followed her like a shadow-standing still whenever she stopped, proceeding on when she went on, patiently sitting down when she sat down, and drinking water when she drank it.
sa nyastacihnāmapi rājalakṣmīṃ tejoviśeṣānumitāṃ dadhānaḥ / āsīdanāviṣkṛtadānarājirantarmadāvastha iva dvipendraḥ // Ragh(K)_2.7 //	Possessing kingly fortune (or royalty) which, with its insignia cast aside, could be inferred from the super-eminence of majesty, he resembled a royal elephant, inwardly.in condition of rut but without the lines of ichor manifested externally.
latāpratānodgrathitaiḥ sa keśairadhijyadhanvā vicacāra dāvam / rakṣāpadeśādguruhomadhenorvanyānvineṣyanniva duṣṭasattvān // Ragh(K)_2.8 //	Marked with hair tied up with the tendrils of creepers, he, with his bow strung, wandered in the wood, as if wishing to discipline the ferocious beasts of the forest, under the pretext of guarding the sacrificial cow of the sage.
udīrayāmāsurivonmadānāmālokaśabdaṃ vayasāṃ virāvaiḥ // Ragh(K)_2.9 //	The trees on either side of the king, mighty like the god with the noose (Varuna), (as he passed on) unattended by servants, uttered, as it were, the exclamations of "Victory to the king; here he comes," by means of the notes of impassioned birds.
avākiranbālalatāḥ prasūnairācāralājairiva paurakanyāḥ // Ragh(K)_2.10 //	On him, bright as fire and worthy of adoration, the young creepers, agitated (urged) by the wind, showered their flowers, as he passed by their side, as the maidens of the city (lit. the daughters of citizens) would the customary la'ja's (fried paddy).
vilokayantyo vapurāpurakṣṇāṃ prakāmavistāraphalaṃ hariṇyaḥ // Ragh(K)_2.11 //	The female deer, gazing on his person declared to be full of feelings, tender with compassion, by their hearts remaining unaffe- cted with fear though he wielded a bow, obtained the fruit of the great expanse of their eyes.
sa kīcakairmārutapūrṇarandhraiḥ kūjadbhirāpāditavaṃśakṛtyam / śuśrāva kuñjeṣu yaśaḥ svamuccairudgīyamānaṃ vanadevatābhiḥ // Ragh(K)_2.12 // pṛktastuṣārairvananirjharāṇāmanokahākampanapuṣpagandhī /	He heard (as he went on) his own lofty glory, loudly carolled from the bowers by the sylvan nymphs, in a manner in. which the purpose of (the accompaniment of the music of) flutes was served by singing bamboos, having their holes filled with wind. The wind charged with the spray of the mountain streams, and bearing the fragrance of the gently shaken flowers of the trees, served (refreshed) him, who, purified by his righteous conduct, was oppressed by heat as he had no umbrella with him.(11) 14.
tamātapaklāntamanātapatramācārapūtaṃ pavanaḥ siṣeve // Ragh(K)_2.13 //	As he, the protector, entered the wood, the forest-confla- gration became extinguished even without a shower (of rain ),.
śaśāma vṛṣṭyāpi vinā davāgnirāsīdviśeṣātphalapuṣpavṛddhiḥ /	exuberant was the growth of fruits and flowers, and among animals, the strong did not oppress the weak.
sañcārapūtāni digantarāṇi kṛtvā dinānte nilayāya gantum /	Having purified the spaces between the directions by their courses, at the close of the day the light of the sun, and.
pracakrame pallavarāgatāmrā prabhā pataṅgasya muneśca dhenuḥ // Ragh(K)_2.15 //	the cow of the sage, both red like the tint of a (fresh ) leaf, began each to return to their abode.
tāṃ devatāpitratithikriyārthamanvagyayau madhyamalokapālaḥ / babhūva sā tena satāṃ matena śraddheva sākṣādvidhinopapannā // Ragh(K)_2.16 //	He, the protector of the middle world, followed her, who supplied to the sage the necessary articles for the rites due to gods, manes and guests; and attended by him, esteemed by the good, she, too, looked like (as graceful as) faith incarnate, when accom- panied by observance (also embodied ).
sa palvalottīrṇavarāhayūthānyāvāsavṛkṣonmukhabarhiṇāni / yayau mṛgādhyāsitaśādvalāni śyāmāyamānāni vanāni paśyan // Ragh(K)_2.17 //	He passed (returned), beholding the woods which were darkening up, in which herds of wild boars were emerging from. the pools, in which peacocks were flying towards their roosting trees and where antelopes were squatting on the swards.
āpīnabhārodvahanaprayatnādgṛṣṭirgurutvāduraso narendraḥ / ubhāvalañcakraturañcitābhyāṃ tapovanāvṛttipathaṃ gatābhyām // Ragh(K)_2.18 //	The cow (that had calved but once) on account of her. exertion to bear the burden of her full udder, and the king by rea- son of his massive body, both decorated with their charming gaits the way back to the penance-grove.
vasiṣṭhadhenoranuyāyinaṃ tamāvartamānaṃ vanitā vanāntāt /	His wife drank him in, from the skirt of the forest, as he returned following the cow of Vasishtha, with winkless eyes, that had fasted long, as it were.
papau nimeṣālasapakṣmapaṅktirupoṣitābhyāmiva locanābhyām // Ragh(K)_2.19 // puraskṛtā vartmani pārthivena pratyudgatā pārthivadharmapatnyā /	Placed in front, on the way, by the lord of the earth, and received by the king's wife ( his associate in religious rites ) advancing towards her, the cow shone between them, like twilight situated between day and night.
pradakṣiṇīkṛtya payasvinīṃ tāṃ sudakṣiṇā sākṣatapātrahastā / praṇamya cānarca viśālamasyāḥ śṛṅgāntaraṃ dvāramivātmasiddheḥ // Ragh(K)_2.21 //	Sudakshinâ, with a pot of whole rice in her hands went. round that milch-cow, keeping her on the right side, and, bowing, worshipped the broad space between her horns (the forehead,) the very door as it were to the fulfilment of her wish.
vatsotsukāpi stimitā saparyāṃ pratyagrahītseti nanandatustau / bhaktyopapanneṣu hi tadvidhānāṃ prasādacihnāni puraḥphalāni // Ragh(K)_2.22 //	They both (the king and queen) were delighted to see that the cow, though eager to meet her calf, patiently accepted the worship offered to her: for, verily the signs of pleasure of (venerable) beings of her type, manifested towards those full of (or, who ap- proach them with) devotion, indicate the near fulfilment (of their wishes).
guroḥ sadārasya nipīḍya pādau samāpya sāndhyaṃ ca vidhiṃ dilīpaḥ / dohāvasāne punareva dogdhrīṃ bheje bhujotsannaripurniṣaṇṇām // Ragh(K)_2.23 //	After having shampooed the feet of his preceptor and his wife and having finished his evening devotions, Dilípa, who had(12) uprooted his foes by (the might of) his arms, again waited upon the milch-cow, as she sat down after the milking was over.
tāmantikanyastabalipradīpāmanvāsya goptā gṛhiṇīsahāyaḥ / krameṇa suptāmanu saṃviveśa suptotthitāṃ prātaranūdatiṣṭhat // Ragh(K)_2.24 //	He, the protector, accompained by his wife, sat close after the cow, near whom were placed a lighted lamp and offerings of worship; and as gradually she slept he slept too, following her example, and rose in the morning when she awoke from sleep.
sapta vyatīyustriguṇāni tasya dinānyamitroddharaṇocitasya // Ragh(K)_2.25 //	Three times seven days'passed away, while he, of adorable fame and accustomed to deliver persons in distress, was thus engaged, with his royal consort, in keeping the vow for the birth of a son.
anyedyurātmānucarasya bhāvaṃ jijñāsamānā munihomadhenuḥ / gaṅgāprapātāntavirūḍhaśaṣpaṃ gaurīgurorgahvaramāviveśa // Ragh(K)_2.26 //	On the following day, the cow that supplied to the sage materials for sacrificial offerings, desirous of testing the devotion of her follower, entered a cave of the mountain Himalaya (lit. Gaurf's father) where tender grass had grown in (or, owing to) the vicinity of the fall of the Ganges.
alakṣitābhyutpatano nṛpeṇa prasahya siṃhaḥ kila tāṃ cakarṣa // Ragh(K)_2.27 //	A lion, it appeared, unobserved in his attack by the king, who had directed his eyes to the beauty of the mountain, con- fident that the cow was not assailable even in thought, by the beasts of prey, forcibly pulled her.
raśmiṣvivādāya nagendradattāṃ nivartayāmāsa nṛpasya dṛṣṭim // Ragh(K)_2.28 // sa pāṭalāyāṃ gavi tasthivāṃsaṃ dhanurdharaḥ kesariṇaṃ dadarśa / adhityakāyāmiva dhātumayyāṃ rodhradrumaṃ sānumataḥ praphultam // Ragh(K)_2.29 //	Her cry, deepened (or, prolonged) by its reverberations in the cave, drew back, by catching as it were in a noose of ropes, the sight of the king, the protector of the distressed, that was riveted on the King of mountains. That eminent archer saw a lion, seated upon the rosy cow, like a full-blossomed lodhra tree, situated on the table-land of a mountain full of red minerals.
tato mṛgendrasya mṛgendragāmī vadhāya vadhyasya śaraṃ śaraṇyaḥ / jātābhiṣaṅgo nṛpatirniṣaṅgāduddhartumaicchatprasabhoddhṛtāriḥ // Ragh(K)_2.30 //	Then the king, who walked as undauntedy (or, proudly) as a lion ( lord of brutes ), who was the protector of the distressed, and who had by force extirpated his enemies, being thus affronted, wished to take out an arrow from his quiver to slay the lion, who merited death.
vāmetarastasya karaḥ praharturnakhaprabhārūṣitakaṅkapattre / saktāṅguliḥ sāyakapuṅkha eva citrārpitārambha ivāvatasthe // Ragh(K)_2.31 //	As he wished to strike, his right hand, with its fingers stuck fast to the haft of the arrow, the heron's feathers whereof were beautifully tinted by the lustre of its nails, remained with its action committed, as it were, to a picture.
rājā svatejobhiradahyatāntarbhogīva mantrapratibaddhavīryaḥ // Ragh(K)_2.32 //	With his rage increased by the paralysis of his arm, the king burnt within himself by the fire of his own energy, which could not touch the offender though very near, like a cobra with its power restrained by charms and herbs.( 13 ) 33.
tamāryagṛhyaṃ nigṛhītadhenurmanuṣyavācā manuvaṃśaketum /	(Then) the lion, who had seized the cow, spoke in human accents to him, who was ever a partisan of the good, who was the most illustrious of Manu's race, and whose strength was as great as that of a lion,-thus astonishing him (all the more).
vismāpayanvismayamātmasiddhau bhūpālasiṃhaṃ nijagāda siṃhaḥ // Ragh(K)_2.33 //	already astonished at his own plight.
alaṃ mahīpāla tava śrameṇa prayuktamapyastramito vṛthā syāt / na pādaponmūlanaśakti raṃhaḥ śiloccaye mūrchati mārutasya // Ragh(K)_2.34 //	"Away, O astonished protector of the earth, with your effort; your weapon, though discharged against me, would prove of no avail; the fury of the storm, though ( able) to uproot trees, has no effect upon a mountain.
avaihi māṃ kiṅkaramaṣṭamūrteḥ kumbhodaraṃ nāma nikumbhamitram // Ragh(K)_2.35 //	Know me to be a servant of the eight-formed god (S'iva), Kumbhodara by name, the friend of Nikumbha, whose back is consecrated by the favour of his planting his foot upon it, when he wishes to mount his bull, white like the mountain Kailása.
amuṃ puraḥ paśyasi devadāruṃ putrīkṛto 'yaṃ vṛṣabhadhvajena / yo hemakumbhastananiḥsṛtānāṃ skandasya mātuḥ payasāṃ rasajñaḥ // Ragh(K)_2.36 //	You see the yonder Devadáru tree; it has been adopted as a son son by S'iva (the bull-bannered god); and it has known the taste of the payas (water-milk) of Skanda's mother issuing out from her (maternal ) breasts, in the form of gold pitchers.
kaṇḍūyamānena kaṭaṃ kadācidvanyadvipenonmathitā tvagasya / athainamadrestanayā śuśoca senānyamālīḍhamivāsurāstraiḥ // Ragh(K)_2.37 // tadā prabhṛtyeva mataṅgajānāṃ trāsārthamasminnahamadrikukṣau / vyāpāritaḥ śūlabhṛtā vidhāya siṃhatvamaṅkāgatasattvavṛtti // Ragh(K)_2.38 //	On one occasion its bark was destroyed by a wild elephant scratching his temples against it; whereupon Pàrvatî (lit. the mountain's daughter) grieved for it, as if it was Skanda (lit. the general of the divine forces ) himself, wounded by the missiles of the demons. From that day forth, I have been placed in this cave of the mountain, by S'iva (the trident-holder) for scaring away the wild elephants, directing me to prey, as a lion, on (lit. making my condition as a lion depend for food on) animals coming within my reach, 39.
tasyālameṣā kṣudhitasya tṛptyai pradiṣṭakālā parameśvareṇa / upasthitā śoṇitapāraṇā me suradviṣaścāndramasī sudheva // Ragh(K)_2.39 //	For the gratification of me, thus situated and hungry, this feast of blood after fast, destined by the supreme lord for this time, and therefore ) coming to me, is enough; just as the nectar of the moon coming as a meal is to (the gratification of) the enemy of gods (Rahu).
sa tvaṃ nivartasva vihāya lajjāṃ gurorbhavāndarśitaśiṣyabhaktiḥ / śastreṇa rakṣyaṃ yadaśakyarakṣaṃ na tadyaśaḥ śastrabhṛtāṃ kṣiṇoti // Ragh(K)_2.40 //	Do you, therefore (lit. you who are thus made helpless), go back, casting off shame; you have shown your devotion, as a disciple, to your preceptor; where it is impossible to protect a charge by means of arms, it (inability to protect) does not damage the reputation of those who wield arms."(14) 41.
iti pragalbhaṃ puruṣādhirājo mṛgādhirājasya vaco niśamya /	On hearing this bold (or, significant) speech of the king of beasts, the king of men ( knowing that) his missile was foiled by the power of S'iva slackened his disregard of himself.
pratyabravīccainamiṣuprayoge tatpūrvasaṅge vitathaprayatnaḥ / jaḍīkṛtastryambakavīkṣitena vajraṃ mumukṣanniva vajrapāṇiḥ // Ragh(K)_2.42 //	And also (he) spoke in reply to him (the lion ), being unsuccessful in his attempt to shoot an arrow, which for the first time knew what failure was, like the wielder of the thunderbolt (Indra) paralysed by the glance of S'iva, when about to discharge his weapon.
saṃruddhaceṣṭasya mṛgendra kāmaṃ hāsyaṃ vacastadyadahaṃ vivakṣuḥ /	"O lord of beasts, laughable, indeed, is the speech, which I, whose actions are restrained, am going to utter; but you know the inward feelings of living beings, and therefore, I will say my say.
mānyaḥ sa me sthāvarajaṅgamānāṃ sargasthitipratyavahārahetuḥ / gurorapīdaṃ dhanamāhitāgnernaśyatpurastādanupekṣaṇīyam // Ragh(K)_2.44 //	All adorable to me is that (S'iva ), who is the cause of the creation, preservation and destruction of all things, animate and inanimate; I cannot also, on the other hand, allow this property of my preceptor to be destroyed before me ( my eyes).
sa tvaṃ madīyena śarīravṛttiṃ dehena nirvartayituṃ prasīda / dināvasānotsukabālavatsā vimucyatāṃ dhenuriyaṃ maharṣeḥ // Ragh(K)_2.45 //	Be pleased, therefore, to make your subsistence on this my body, and let this cow of the great sage be liberated, whose young calf will be anxiously looking for her (return) at the close of the day." 46.
athāndhakāraṃ girikandarāṇāṃ daṃṣṭrāmayūkhaiḥ śakalāni kurvan / bhūyaḥ sa bhūteśvarapārśvavartī kiñcidvihasyārthapatiṃ babhāṣe // Ragh(K)_2.46 //	On hearing these words, that attendant of S'iva (lit. the lord of beings) laughed a little and spoke once more to the king (lit. the lord of riches), rending into pieces the gloom of the mountain-caves by the gleam (rays) of his teeth.
ekātapatraṃ jagataḥ prabhutvaṃ navaṃ vayaḥ kāntamidaṃ vapuśca / alpasya hetorbahu hātumicchan vicāramugdhaḥ pratibhāsi me tvam // Ragh(K)_2.47 //	"Sovereignty over the world marked by one imperial umbrella, prime youth, and this handsome form-you who wish to forego all these for the sake of a trifle, seem to me to be want- ing in discernment.
bhūtānukampā tava cediyaṃ gaurekā bhavetsvastimatī tvadante /	If this be your compassion for living beings, this cow alone will be happy (saved) by your death.
jīvanpunaḥ śaśvadupaplavebhyaḥ prajāḥ prajānātha piteva pāsi // Ragh(K)_2.48 //	But if alive, O king of men, you, like a father, will ever protect your subjects from calamities.
athaikadhenoraparādhadaṇḍādguroḥ kṛṣāṇupratimādbibheṣi / śakyo 'sya manyurbhavatā vinetuṃ gāḥ koṭiśaḥ sparśayatā ghaṭodhnīḥ // Ragh(K)_2.49 //	Now if you dread your preceptor, who having an only cow, will be burning with anger at your offence, (like a blazing ) fire, it is possible for you to pacify his wrath by presenting him with crores of cows with udders as big as pitchers.
mahītalasparśanamātrabhinnamṛddhaṃ hi rājyaṃ padamaindramāhuḥ // Ragh(K)_2.50 //	Preserve, therefore, your mighty body, the enjoyer of blessings: for the wise say that a prosperous kingdom is identical with the heaven of Indra, only differing in that it is situated on the earth."( 15 ) 51.
etāvaduktvā virate mṛgendre pratisvanenāsya guhāgatena /	When the lord of beasts had ceased, having said this much, the mountain too, on account of the echo of his words resounding in the caves, seemed affectionately and loudly to say the very same thing to the king.
kṣatātkila trāyata ityudagraḥ kṣattrasya śabdo bhuvaneṣu rūḍhaḥ / rājyena kiṃ tadviparītavṛtteḥ prāṇairupākrośamalīmasairvā // Ragh(K)_2.53 //	Having heard the words of the attendant of S'iva, the king of men spoke again, his compassion being excited all the more, being looked at with terror-smitten eyes by the cow in the grip of the lion. "The noble name of kshatra, (the military caste) is verily known in the worlds as 'the one that protects from danger'; but to one who acts in opposition to this, of what use is a kingdom, or a life tarnished by infamy? 54.
kathaṃ ca śakyo 'nunayo maharṣerviśrāṇanādanyapayasvinīnām / imāmanūnāṃ surabheravaihi rudraujasā tu prahṛtaṃ tvayāsyām // Ragh(K)_2.54 //	And how is the pacification of the anger of) the great ·sage possible by the gift of ordinary milch-cows? Know that this cow is in no way inferior to Surabhi (the divine cow); that you have attacked her is only through the power of Rudra.
seyaṃ svadehārpaṇaniṣkrayeṇa nyāyyaṃ mayā mocayituṃ bhavattaḥ /	It is, therefore, proper that I should deliver this one from you by offering my own body as a ransom.
na pāraṇā syādvihatā tavaivaṃ bhavedaluptaśca muneḥ kriyārthaḥ // Ragh(K)_2.55 // bhavānapīdaṃ paravānavaiti mahānhi yatnastava devadārau /	Thus your meal- after-fast will not be obstructed, and the means of the sage's rites also will not be destroyed. You, too, who are a servant, know this-for great is your care for the Devada' ru tree-that it is not possible (for a servant) to stand before his employer, himself unhurt, after having allowed his charge to perish.
kimapyahiṃsyastava cenmato 'haṃ yaśaḥśarīre bhava me dayāluḥ / ekāntavidhvaṃsiṣu madvidhānāṃ piṇḍeṣvanāsthā khalu bhautikeṣu // Ragh(K)_2.57 //	Or, if somehow you deem me not fit to be killed, be compassionate to my (other) body consisting of glory; for in the case of people like me, there is utter want of regard for the necessarily perishable lumps of matter ( the bodies).
sambandhamābhāṣaṇapūrvamāhurjātaḥ sa nau saṅgatayorvanānte / tadbhūtanāthānuga nārhasi tvaṃ sambandhino me praṇayaṃ vihantum // Ragh(K)_2.58 //	They say that a friendly connexion has conversation for its cause; and the same has been formed between us, (thus) met together in this forest tract; hence, O follower of the lord of beings, it behoves you not to reject the request of me, your connexion." 59.
tatheti gāmuktavate dilīpaḥ sadyaḥ pratistambhavimuktabāhuḥ / sa nyastaśastraṃ haraye svadehamupānayatpiṇḍamivāmiṣasya // Ragh(K)_2.59 //	To the lion, who said 'So let be,' Dilipa, his hand released from restraint the very moment, offered, after laying down his weapons, his body, like (as if it were no better than) a lump of flesh.
tasminkṣaṇe pālayituḥ prajānāmutpaśyataḥ siṃhanipātamugram / avāṅmukhasyopari puṣpavṛṣṭiḥ papāta vidyādharahastamuktā // Ragh(K)_2.60 //	At that moment upon the king (lit. the protector of the people ) expecting, with his face downwards, the terrible leap of(16) the lion, there fell a shower of flowers discharged by the hands of the Vidya' dharas.
dadarśa rājā jananīmiva svāṃ gāmagrataḥ prasraviṇīṃ na siṃham // Ragh(K)_2.61 //	Hearing the words gladdening like nectar-'Rise, my child, uttered there, the king rising, beheld the cow standing before him like his own mother, with milk dripping down (from her udder), and not the lion.
ṛṣiprabhāvānmayi nāntako 'pi prabhuḥ prahartuṃ kimutānyahiṃsrāḥ // Ragh(K)_2.62 //	The cow thus addressed the astonished king,-'O benevo- lent one! Creating an illusion, you have been tested by me ; by virtue of the sage's power, not even the god of death can strike me; much less other destructive animals.
bhaktyā gurau mayyanukampayā ca prītāsmi te putra varaṃ vṛṇīṣva /	My son, by your devotion to your preceptor and your compassion for me I am pleased (with you); ask a boon (of me); know me to be not only the producer of milk, but also a fulfiller of wishes when pleased.' 64.
tataḥ samānīya sa mānitārthī hastau svahastārjitavīraśabdaḥ / vaṃśasya kartāramanantakīrtiṃ sudakṣiṇāyāṃ tanayaṃ yayāce // Ragh(K)_2.64 //	Then he, who had honoured supplicants and earned the title of Hero by the might of his arms, joined his hands, and asked for a son by Sudakshiná, such as would be the founder of a dynasty and earn an undying reputation.
santānakāmāya tatheti kāmaṃ rājñe pratiśrutya payasvinī sā / dugdhvā payaḥ pattrapuṭe madīyaṃ putropayuṅkṣveti tamādideśa // Ragh(K)_2.65 //	Having promised, by saying 'So be it,' the gift of the desire of the king who longed for progeny, the milch-cow com- manded him thus-'My son, extract my milk in a vessel of leaves, and drink it.' 66.
ūdhasyamicchāmi tavopabhoktuṃ ṣaṣṭhāṃśamurvyā iva rakṣitāyāḥ // Ragh(K)_2.66 //	'I wish to drink your milk, O mother, out of what will remain after the calf has sucked and after it has been used for the sacrificial rites, having received the sage's permission, just as I receive the sixth portion of the ( produce of the ) earth, protected by me.' 67.
itthaṃ kṣitīśena vasiṣṭhadhenurvijñāpitā prītatarā babhūva /	Thus addressed by the king, the cow of Vasishtha became still more pleased, and followed by him, returned with an easy pace from the Himalayan cave to the hermitage.
tasyāḥ prasannendumukhaḥ prasādaṃ gururnṛpāṇāṃ gurave nivedya / mukhaprasādānumitaṃ priyāyai śaśaṃsa vācā punaruktayaiva // Ragh(K)_2.68 //	The lord of kings, with his face bright like the smiling moon (or his moonlike face smiling), informed his preceptor and then his beloved wife, of the favour of the cow, in words which seemed to be a repetition, as it was already inferred (by them) from the external signs of ecstatic joy.
sa nandinīstanyamaninditātmā sadvatsalo vatsanipītaśeṣam / papau vasiṣṭhena kṛtābhyanujñaḥ śuddhaṃ yaśo bhūya ivāvitṛptaḥ // Ragh(K)_2.69 //	He, of unblemished character, and kind to the virtuous, having been permitted by Vasishtha, drank, with unslaked thirst, the milk of Nandiní, that remained after the calf had been gratified and the offerings made, as if it were his own spotless fame embodied.Canto II.] ( 17 ) 70.
prātaryathoktavratapāraṇānte prāsthānikaṃ svastyayanaṃ prayujya / tau dampatī svāṃ prati rājadhānīṃ prasthāpayāmāsa vaśī vasiṣṭhaḥ // Ragh(K)_2.70 //	The next morning, the repast at the conclusion of the aforesaid vow being over, the self-restrained Vasishtha, dismissed the (royal) couple to return to their own capital, after having pronounced on them the benediction proper at the time of depar- ture (or, having performed the ceremony that was to ensure them a happy journey).
pradakṣiṇīkṛtya hutaṃ hutāśamanantaraṃ bharturarundhatīṃ ca / dhenuṃ savatsāṃ ca nṛpaḥ pratasthe sanmaṅgalodagratarānubhāvaḥ // Ragh(K)_2.71 //	Having circumambulated the holy fire to which the offer- ings were made, and Arundhatí just after her husband, and then the cow too, together with her calf, the king started on his journey, his prowess being rendered mightier by the auspicious rites ( performed at his departure ).
śrotrābhirāmadhvaninā rathena sa dharmapatnīsahitaḥ sahiṣṇuḥ / yayāvanudghātasukhena mārgaṃ sveneva pūrṇena manorathena // Ragh(K)_2.72 //	The patient king, accompanied by his lawfully wedded wife, traversed the road, driving in a chariot, the sound of which was agreeable to the ear and which was comfortable on account of the absence of jolting, as if it was his own desire now fulfilled.
tamāhitotkaṇṭhamadarśanena prajāḥ prajārthavratakarṣitāṅgam / netraiḥ papustṛptimanāpnuvadbhirnavoditaṃ nāthamivauṣadhīnām // Ragh(K)_2.73 //	His subjects, in whom a longing to see him) was pro- duced on account of his absence, drank him in, as it were, whose form was enaciated by the observance of the vow for progeny, with eyes ever unsatiated, just as they would the newly-risen moon (lit. the lord of plants), creating a longing ( for his sight) and his body wasted (waned) by the vow (of being devoured from day to day, ) for (in the interest of the creation.
purandaraśrīḥ puramutpatākaṃ praviśya paurairabhinandyamānaḥ / bhuje bhujaṅgendrasamānasāre bhūyaḥ sa bhūmerdhuramāsasañja // Ragh(K)_2.74 //	He, with the splendour of Indra (lit. the Splitter of the demons' towns), entered the city decorated with flying ban- ners, greeted with acclamations by the citizens, and once again placed the yoke of the earth on his arm whose sustaining strength equalled that of the serpent-king (resumed the government ).
atha nayanasamutthaṃ jyotiratreriva dyauḥ surasaridiva tejo vahniniṣṭhyūtamaiśam / narapatikulabhūtyai garbhamādhatta rājñī gurubhirabhiniviṣṭaṃ lokapālānubhāvaiḥ // Ragh(K)_2.75 //	Then (in course of time) for the well-being of the race of the king, the queen bore a foetus, formed with the weighty essences of the guardians of regions, as the sky bore the luminary sprung from the tears of Atri, and as the divine river (Gangâ ) bore S'iva's energy deposited by Agni ( the fire-god).
athepsitaṃ bharturupasthitodayaṃ sakhījanodvīkṣaṇakaumudīmukham / nidānamikṣvākukulasya santateḥ sudakṣiṇā dauhadalakṣaṇaṃ dadhau // Ragh(K)_3.1 //	After that (conception ) Sudakshina bore the evidence (signs) of pregnancy, which was (as it were,) the very desire of her husband, with its fulfilment approached, which was (as gladdening to the eyes of her female friends as the appearance of the moon-light, and which was again the cause of the perpetua- tion of Ikshváku's race.
sthitālpatārāṃ karuṇendumaṇḍalāṃ vibhātakalpāṃ rajanīṃ vyaḍambayat // Ragh(K)_3.2 //	Not wearing all her ornaments on account of the attenuation of her body and with her face pale like the lodhra flower, she looked like the night bordering on dawn, with but a few'stars dis- played (therein) and marked by the moon shining dimly.
tadānanaṃ sevitamṛttikālavaṃ nṛpaḥ samāghrāya na tṛptimāyayau / karīva siktaṃ pṛṣataiḥ payomucāṃ śucivyapāye vanarājipalvalam // Ragh(K)_3.3 //	The king smelling, in private, her mouth fragrant with clay (that she would eat ), never felt satisfaction, like an elephant smelling a small pond in a forest tract, sprinkled over with drops from the clouds, at the close of summer.
divaṃ marutvāniva bhokṣyate mahīṃ digantaviśrāntaratho hi matsutaḥ / ato 'bhilāṣe prathamaṃ tathāvidhe mano babandhānyarasānvilaṅghya sā // Ragh(K)_3.4 //	Her (future) son was to enjoy (the sovereignty of) the earth with his (conquering) chariot stopping only at the extremities of the quarters, as the lord of the gods enjoys that of heaven; hence it was that she (the queen ) set her heart upon an object of that kind (clay) in preference to all other objects of taste.
na me hriyā śaṃsati kiñcidīpsitaṃ spṛhāvatī vastuṣu keṣu māgadhī / iti sma pṛcchatyativelamādṛtaḥ priyāsakhīruttarakosaleśvaraḥ // Ragh(K)_3.5 //	"Through bashfulness the princess of Magadha does not tell me her wish; what are the things that she has a craving for ?-" thus did the lord of the North-Kosalas constantly ask his wife's companions in loving concern.
upetya sā dohadaduḥkhaśīlatāṃ yadeva vavre tadapaśyadāhṛtam / na hīṣṭamasyāstridive 'pi bhūpaterbabhūva duṣprāpamadhijyadhanvanaḥ // Ragh(K)_3.6 //	Having reached the state painful on account of hankerings of pregnancy, whatever she asked for, she saw brought to her ; for there was nothing, which being desired by him, was unattain - able to him, who had his bow strung, even if it were in heaven.
samudgayorvāraṇadantakośayorbabhāra kāntiṃ gavalāpidhānayoḥ // Ragh(K)_3.7 // krameṇa nistīrya ca dohadavyathāmupoḍhagātropacayā rarāja sā / purāṇapattrāpagamādanantaraṃ lateva sannaddhamanojñapallavā // Ragh(K)_3.8 // nidhānagarbhāmiva sāgarāmbarāṃ śamīmivābhyantaralīnapāvakām /	Gradually getting over the painful state of pregnancy- cravings, she appeared beautiful, as her limbs grew plump, like a creeper, which after the fall of the old leaves, is dressed in lovely foliage. As days rolled on, her two breasts, growing exceedingly plump, and with nipples black all round, far surpassed the love- liness of a couple of well-formed lotus-buds with black bees per- ched upon them.
nadīmivāntaḥsalilāṃ sarasvatīṃ nṛpaḥ sagarbhāṃ mahiṣīmamanyata // Ragh(K)_3.9 //	(19) S'amî tree with fire lying concealed inside, or the river Sarasvati with its ( stream of) water underground.
priyānurāgasya manaḥsamunnaterbhujārjitānāṃ ca digantasampadām / yathākramaṃ puṃsavanādikāḥ kriyā dhṛteśca dhīraḥ sadṛśīrvyadhatta saḥ // Ragh(K)_3.10 //	He performed, in due order, the ceremonies (attendant on pregnancy) beginning with Pumsavana, in a style worthy of the love he bore to his beloved queen, of the loftiness of his mind, of the vast wealth he had acquired by the might of his arms from all quarters, and also of his great joy.
surendramātrāśritagarbhagauravāt prayatnamuktāsanayā gṛhāgataḥ / tayopacārāñjalikhinnahastayā nananda pāriplavanetrayā nṛpaḥ // Ragh(K)_3.11 // kumārabhṛtyaiḥ kuśalairadhiṣṭhite bhiṣagbhirāptairatha garbhaveśmani / niratyayāya prasavāya tasthuṣī babhau samāsannaphalā kriyeva sā // Ragh(K)_3.12 //	Whenever the king visited her apartment he was delighted to see how she, with tremulous glances, rose from her seat with difficulty on account of the heaviness of the foetus with the portions of the mighty gods (infused therein), and also experienced languor even as she joined together her hands to make the customary bow. Now, in due season, the development of the foetus having been effected by trusty physicians, well versed in the treatment of infants, the husband saw, with a delighted mind, his beloved queen, about to be delivered, like the sky, over-hung with clouds, about to discharge a shower of rain at the close of summer.
grahaistataḥ pañcabhiruccasaṃśrayairasūryagaiḥ sūcitabhāgyasampadam / asūta putraṃ samaye śacīsamā trisādhanā śaktirivārthamakṣatam // Ragh(K)_3.13 //	Then she, comparable to S'achi, gave birth to a son, whose most exalted fortune was betokened by five planets in their (respective) ascendant high position, and not approaching the sun, just as regal power, arising from three agencies, produces in- exhaustible wealth.
babhūva sarvaṃ śubhaśaṃsi tatkṣaṇaṃ bhavo hi lokābhyudayāya tādṛśām // Ragh(K)_3.14 //	The very moment the quarters brightened; and the holy fire received the oblations with its flame turning to the right: (thus) everything indicated auspiciousness: for the birth of persons like him is for the good of the world.
niśīthadīpāḥ sahasā hatatviṣo babhūvurālekhyasamarpitā iva // Ragh(K)_3.15 //	Deprived of their lustre all of a sudden by the natural re- fulgence of the well-born babe, spreading around the bed in the lying-in-chamber, the midnight lamps became as if they were painted in a picture.
janāya śuddhāntacarāya śaṃsate kumārajanmāmṛtasammitākṣaram / adeyamāsīttrayameva bhūpateḥ śaśiprabhaṃ chattramubhe ca cāmare // Ragh(K)_3.16 //	To the attendants of the inner apartments announcing the birth of a son, in words which rivalled nectar in sweetness, there were only three things which the king could not give, viz. his (imperial) umbrella bright as the moon, and, the two chauries ( being the insignia of royalty ).
mudā śarīre prababhūva nātmanaḥ payodhirindūdayamūrchito yathā // Ragh(K)_3.17 //	As the king was looking intently at (lit. less spot, his intense joy could not be contained in himsef, like the flood of the great ocean at the appearance of the moon.
sa jātakarmaṇyakhile tapasvinā tapovanādetya purodhasā kṛte / dilīpasūnurmaṇirākarodgataḥ prayuktasaṃskāra ivādhikaṃ babhau // Ragh(K)_3.18 //	When the entire natal ceremony was performed by the ascetic-priest coming from the penance-forest, the son of Dilipa shone forth with additional brilliance (all the more ), like a gem produced in a mine, after it has undergone the process of polishing.
sukhaśravā maṅgalatūryaniḥsvanāḥ pramodanṛttaiḥ saha vārayoṣitām / na kevalaṃ sadmani māgadhīpateḥ pathi vyajṛmbhanta divaukasāmapi // Ragh(K)_3.19 //	The sounds of the auspicious musical instruments, pleas- ant to hear, accompanied by the delightful dances of the courte- sans, went on, not only in the palace of hin, the busband of the Magadha princess, but also in the regions of the denizens of heaven.
na saṃyatastasya babhūva rakṣiturvimocayedyaṃ sutajanmaharṣitaḥ /	There was no prisoner-such a protector he was-whom, delighted at the birth of a son, he could release; only his own self was, on that occasion, liberated from the bond, called 'the ances- tors' debt'.
avekṣya dhātorgamanārthamarthaviccakāra nāmnā raghumātmasambhavam // Ragh(K)_3.21 //	Foreseeing that the boy would go to the end of all learn- ing and also of his foes in battle (i.e. would extirpate them ), the king, conversant with the meaning of words, named his son Raghu, taking into consideration the meaning 'to go' of the root.
pituḥ prayatnātsa samagrasampadaḥ śubhaiḥ śarīrāvayavairdine dine / pupoṣa vṛddhiṃ haridaśvadīdhiteranupraveśādiva bālacandramāḥ // Ragh(K)_3.22 // umāvṛṣāṅkau śarajanmanā yathā yathā jayantena śacīpurandarau /	Under the care of the father, who was endowed, with for- tune of every kind, the boy developed, day by day, the graceful limbs of his body, just as the young moon waxes in size by the in- fusion of the rays of the sun (lit, he who drives green horses). As Umà and S'iva (lit. the bull-badged god) were delighted with Kártikeya (lit. one born in reeds), as S'achi and Indra (lit. the cleaver of the demons' cities) were delighted with Jayanta, so were the king and the Magadha princess, equal to them, pleased with their son, who was also like them (the two divine boys).
rathāṅganāmnoriva bhāvabandhanaṃ babhūva yatprema parasparaṃ prati / vibhaktamapyekasute na tattayoḥ parasparasyopari paryahīyata // Ragh(K)_3.24 //	The love which existed mutually between the king and the queen and which had united together their hearts, like that of a pair of Chakrava' ka birds, increased (deepened) on the part of each towards the other, though now shared by their only son.
yadāha dhātryā prathamoditaṃ vaco yayau tadīyāmavalambya cāṅgulim / abhūcca namraḥ praṇipātaśikṣayā piturmudaṃ tena tatāna so 'rbhakaḥ // Ragh(K)_3.25 //	The boy lisped the words first uttered by the nurse, walked holding her finger, and bent low (bowed) by being taught to make obeisance; by these acts he added to the joy of his father. e. a long period of disappointment ), or for a long time (or, came to the state of knowing-became conscious of the pleasure of the touch of his son after a long time-so much benumbed with joy he was).
amaṃsta cānena parārdhyajanmanā sthiterabhettā sthitimantamanvayam / svamūrtibhedena guṇāgryavṛttinā patiḥ prajānāmiva sargamātmanaḥ // Ragh(K)_3.27 //	And he, no transgressor of the prescribed bounds, consider- ed his line as well perpetuated by him ( his son) of exalted birth, a different form of his own person and the possessor of the foremost of merits, just as Brahmá (lit. the lord of creation) considers his own creation well preserved by that other form of his own self (Vishnu ) working in combination with Satva, the best of the three qualities (that govern the world.) 28.
sa vṛttacūlaścalakākapakṣakairamātyaputraiḥ savayobhiranvitaḥ / liperyathāvadgrahaṇena vāṅmayaṃ nadīmukheneva samudramāviśat // Ragh(K)_3.28 //	When his tonsure ceremo mony was performed, he, accompanied by the ministers' sons of the same age and with waving locks of hair, mastered properly the alphabet, and thereby entered the vast field of learning, as one enters the sea through the mouth of a river.
athopanītaṃ vidhivadvipaścito vininyurenaṃ guravo gurupriyam / avandhyayatnāśca babhūvuratra te kriyā hi vastūpahitā prasīdati // Ragh(K)_3.29 //	And, when he had been duly invested with the sacred thread, learned preceptors educated him, a favourite with pre- ceptors (or, who loved his preceptors), and found their labours not wasted upon him; for labour bestowed on a proper object ( or, instruction imparted to a worthy recipient) is productive of fruit.
dhiyaḥ samagraiḥ sa guṇairudāradhīḥ kramāccatasraścaturarṇavopamāḥ / tatāra vidyāḥ pavanātipātibhirdiśo haridbhirharitāmiveśvaraḥ // Ragh(K)_3.30 //	Gifted with a noble understanding, he, by the force of all the excellences of intellect, got across (mastered), in succession, the four lores, comparable in vastness to the four oceans, as the lord of the directions (the sun) traverses the four quarters means of his bay steeds, surpassing the wind in velocity.
tvacaṃ sa medhyāṃ paridhāya rauravīmaśikṣatāstraṃ pitureva mantravat /	Having put on the holy skin of the ruru ( a kind of deer) he learnt the art of using missiles, together with their incantations, from his father himself; for not only was his sire the sole sovereign on earth, but the sole archer also.
raghuḥ kramādyauvanabhinnaśaiśavaḥ pupoṣa gambhīramanoharaṃ vapuḥ // Ragh(K)_3.32 //	Like a young calf reaching the state of a full-grown bull, and the young elephant attaining the condition of a huge elephant, Raghu, whose childhood was gradually supplanted by youth, developed a frame charming by its gravity ( dignity).
narendrakanyāstamavāpya satpatiṃ tamopahaṃ dakṣasutā ivābabhuḥ // Ragh(K)_3.33 //	daughters of kings having found an excellent husband in him, shone like the daughters of Daksha married to the moon ( lit. the god who chases away darkness.) 34.
yuvā yugavyāyatabāhuraṃsalaḥ kavāṭavakṣāḥ pariṇaddhakandharaḥ / vapuṣprakarṣādajayadguruṃ raghustathāpi nīcairvinayādadṛśyata // Ragh(K)_3.34 //	Young, with arms long as the yoke of a car, a chest broad like a folding-door, and a neck well-turned, Raghu surpassed his father by his physical excellence and yet looked lowly before him through humility. Then the king wishing to lighten the exceedingly heavy burden of governing his subjects long sustained by himself, invest- ed Raghu with the title of young king', seeing that he was dis- ciplined (fitted for it) both by nature and by education.
agacchadaṃśena guṇābhilāṣiṇī navāvatāraṃ kamalādivotpalam // Ragh(K)_3.36 //	S'rí (the goddess of royal fortune) who always loves merits, went over partially from her original seat, the old king, to the new resting place called 'the young king', just as the goddess of beauty passes from a lotus to a fresh blown one, 37.
uṣarbudhaḥ sārathineva vāyunā ghanavyapāyena gabhastimāniva / babhūva tenātitarāṃ durutsahaḥ kaṭaprabhedena karīva pārthivaḥ // Ragh(K)_3.37 //	Like the fire by its associate the wind, like the sun by its ally the autumnal season (lit. in which there is the disappearance of clouds), and like the elephant by its auxiliary, the bursting of his temples, the king ( Dilipa) became most irresistible by his help.
niyujya taṃ medhyaturaṅgarakṣaṇe dhanurdharai rājasutairanudrutam / apūrṇamekena śatakratūpamaḥ śataṃ kratūnāmapavighnamāpa saḥ // Ragh(K)_3.38 // ataḥ paraṃ tena makhāya yajvanā turaṅgamutsṛṣṭamanargalaṃ punaḥ /	Having appointed him, a pre-eminent archer, followed by (other) princes, to guard the sacrificial horse, he, comparable to Indra (lit. the performer of a hundred sacrifices) performed a hundred sacrifices short by one, without obstruction. The horse let loose (to wander) unrestrained, after that, for another sacrifice, by that sacrificer, Indra in an invisible form, It is said, took off, even before the eyes of the guards armed with bow's.
vasiṣṭhadhenuśca yadṛcchayāgatā śrutaprabhāvā dadṛśe 'tha nandinī // Ragh(K)_3.40 //	Then, just as the prince's army stood amazed, not know- ing what to do in their bewilderiment, there was seen Nandinf, Vasishtha's cow, of well-known power, coming accidentally.
tadaṅganiḥṣyandalavena locane pramṛjya puṇyena puraskṛtaḥ satām / atīndriyeṣvapyupapannadarśano babhūva bhāveṣu dilīpanandanaḥ // Ragh(K)_3.41 //	The son of Dilipa, honoured by the good, having cleansed his eyes with the holy water that flowed from her body (her urine ), was endued with the power of seeing objects even beyond the ken of senses.
avocadenaṃ gaganaspṛśā raghuḥ svareṇa dhīreṇa nivartayanniva // Ragh(K)_3.43 //	The prince (lit. Recognizing him to be Indra, by his hundreds of wink- less eyes, and also by his green steeds, Raghu addressed him in a deep voice that reached the vaults of heaven, forcing him to turn back, as it were, thereby.
makhāṃśabhājāṃ prathamo manīṣibhistvameva devendra yadā nigadyase / ajasradīkṣāprayatasya madguroḥ kriyāvighātāya kathaṃ pravartase // Ragh(K)_3.44 //	"O lord of gods ! you alone are described by sages as the first of those who enjoy shares at sacrifices; how do you then proceed to obstruct the sacrifical rites of my sire, purified for ( engaged in ) the constant performance of sacrificial vow? 45.
trilokanāthena satā makhadviṣastvayā niyāmyā nanu divyacakṣuṣā / sa cetsvayaṃ karmasu dharmacāriṇāṃ tvamantarāyībhavasi cyuto vidhiḥ // Ragh(K)_3.45 //	The enemies of sacrifices ought, indeed, to be always check- ed (suppressed) by you, the lord of the three worlds, possessed of divine power of vision; but if you yourself stand in the way of the rites undertaken by the righteous, all pious work must be at an end ! 46.
pathaḥ śucerdarśayitāra īśvarā malīmasāmādadate na paddhatim // Ragh(K)_3.46 //	Therefore, O Indra, it behoves you to set free the horse, the most essential part of the great sacrifice; great lords, who lead the paths pointed out by the Vedas, never adopt a sinful course.' 47.
iti pragalbhaṃ raghuṇā samīritaṃ vaco niśamyādhipatirdivaukasām / nivartayāmāsa rathaṃ savismayaḥ pracakrame ca prativaktumuttaram // Ragh(K)_3.47 //	On hearing these bold words spoken by Raghu, the lord of the denizens of heaven, astonished, turned back the chariot and began to return a reply.
yathāttha rājanyakumāra tattathā yaśastu rakṣyaṃ parito yaśodhanaiḥ / jagatprakāśaṃ tadaśeṣamijyayā bhavadgururlaṅghayituṃ mamodyataḥ // Ragh(K)_3.48 //	"O son of a kshatriya, what you say is all true; but those who regard their fame as their wealth must protect it from their enemies; and your father, by his sacrifices, is bent upon eclipsing the same in its entirety of me, so well known in all the worlds.
hariryathaikaḥ puruṣottamaḥ smṛto maheśvarastryambaka eva nāparaḥ /	As Hari alone is known by the name of Purushottama, as Tryambaka (the three-eyed god), and none else, is styled Mahes'- vara, so do the sages know me as S'atakratu.
tathā vidurmāṃ munayaḥ śatakratuṃ dvitīyagāmī na hi śabda eṣa naḥ // Ragh(K)_3.49 //	This designation (respectively attached to us three ) does not refer (belong) to a second.
ato 'yamaśvaḥ kapilānukāriṇā pitustvadīyasya mayāpahāritaḥ / alaṃ prayatnena tavātra mā nidhāḥ padaṃ padavyāṃ sagarasya santateḥ // Ragh(K)_3.50 //	Therefore has this horse of your father been carried away by me, imitating the sage Kapila; away with (nothing will be gained from an effort in this matter; set not your foot upon the path pursued by Sagara's progeny (sons.)" 51.
tataḥ prahasyāha punaḥ purandaraṃ vyapetabhīrbhūmipurandarātmajaḥ / gṛhāṇa śastraṃ yadi sarga eṣa te na khalvanirjitya raghuṃ kṛtī bhavān // Ragh(K)_3.51 //	Then the dauntless protector of the sacrificial horse laugh- ed and again addressed Purandara:-"Take up your weapon, if this be your determination; you will never gain your object without conquering Raghu.' 52.
sa evamuktvā maghavantamunmukhaḥ kariṣyamāṇaḥ saśaraṃ śarāsanam /	(the right leg advanced and the left one drawn in), thus imitating the god S'iva.
raghoravaṣṭambhamayena pattriṇā hṛdi kṣato gotrabhidapyamarṣaṇaḥ / navāmbudānīkamuhūrtalāñchane dhanuṣyamoghaṃ samadhatta mārgaṇam // Ragh(K)_3.53 //	The resentful splitter of mountains (Indra) too, struck at heart by Raghu's shaft consisting of his defiant posture, (or, spirit) placed an arrow, that never failed to hit its mark, on his bow, which shows itself as the momentary signal of the fresh clouds (i.e. the rainbow).
papāvanāsvāditapūrvamāśugaḥ kutūhaleneva manuṣyaśoṇitam // Ragh(K)_3.54 //	The arrow of Indra, accustomed to drink the blood of ter- rific demons, entered (penetrated) the broad chest of the son of Dilfpa, and drank, out of curiosity as it were, the blood of a human being, never tasted before.
hareḥ kumāro 'pi kumāravikramaḥ suradvipāsphālanakarkaśāṅgulau /	The prince also, with the prowess of Kumâra (Kàrtikeya), planted an arrow, marked with his own name, into Indra's arm, whose fingers were roughened by patting Airàvata (the celestial elephant), and which bore the prints of S'achf's ornamental paint- ings.
jahāra cānyena mayūralāñchanaṃ śareṇa śakrasya mahāśanidhvajam / cukopa tasmai sa bhṛśaṃ suraśriyaḥ prasahya keśavyaparopaṇādiva // Ragh(K)_3.56 //	And with another arrow, having peacock's feathers attached to it, he struck down Indra's great thunderbolt banner; whereupon the god got mightily wroth with him, as if he had forcibly cropped off the hair of the deity presiding over the fortune of the celestials.
babhūva yuddhaṃ tumulaṃ jayaiṣiṇoradhomukhairūrdhvamukhaiśca pattribhiḥ // Ragh(K)_3.57 //	A fierce fight then ensued between the two, each intent on overcoming the other, by means of feathered shafts, as frightful as winged snakes, flying upwards and downwards, while the Siddhas on the one side and the soldiers on the other stood by (as silent spectators).
śaśāka nirvāpayituṃ na vāsavaḥ svataścyutaṃ vahnimivādbhirambudaḥ // Ragh(K)_3.58 //	Even with showers of missiles poured in ceaseless succes- sion Indra was not able to extinguish him, the receptacle of exceedingly unbearable (irresistible) energy (power), as the cloud cannot extinguish by its waters the fire (of lightning) emitted from itself.
tataḥ prakoṣṭhāddharicandanāṅkitāt pramathyamānārṇavadhīranādinīm / raghuḥ śaśāṅkārdhamukhena pattriṇā śarāsanajyāmalunādbiḍaujasaḥ // Ragh(K)_3.59 //	Then Raghu, by means of an arrow with a head shaped like the crescent of the moon, cut off the string of Indra's bow, roaring deep, like an ocean that is being churned, ou his fore-arm, besmeared with the sandal of heaven. He, with his jealous anger intensified, threw aside the bow, and with a desire to slay his very powerful adversary, took up the thunderbolt, blazing with a circle of radiance and accustomed to clip off the wings of mountains.
raghurbhṛśaṃ vakṣasi tena tāḍitaḥ papāta bhūmau saha sainikāsrubhiḥ /	] (25) an instant the pain caused thereby, he rose up, together with their acclamations of joy.
tutoṣa vīryātiśayena vṛtrahā padaṃ hi sarvatra guṇairvidhīyate // Ragh(K)_3.62 //	Even then, the slayer of Vritra (Indra) was pleased by the supreme valour of him who had long maintained a hostile position, cruel by the use of arms; for a foot is set (an impression is made) everywhere by merits.
asaṅgamadriṣvapi sāravattayā na me tvadanyena visoḍhamāyudham / avaihi māṃ prītamṛte turaṅgamādvaraṃ vṛṇīṣveti tamāha vṛtrahā // Ragh(K)_3.63 //	"By none but you, was ever withstood (borne the stroke of) my weapon, unobstructed in its operation, by reason of its inherent strength, even on mountains; know me to be pleased; excepting the horse what else would you have (from me)?''-so said Vásava to him in clear (unmistakable) terms.
tato niṣaṅgādasamagramuddhṛtaṃ suvarṇapuṅkhadyutirañjitāṅgulim / dilīpasūnuḥ pratisaṃharanniṣuṃ priyaṃ vadaḥ pratyavadatsureśvaram // Ragh(K)_3.64 //	Then the son of the lord of kings, putting back an arrow which was not entirely drawn out from the quiver, and which tinged his fingers with the lustre of the gold on its feathered haft, replied (now) speaking sweetly to the lord of gods.
amocyamaśvaṃ yadi manyate prabhustataḥ samāpte vidhineva karmaṇi / ajasradīkṣātanuradya me guruḥ kratoraśeṣeṇa phalena yujyatām // Ragh(K)_3.65 //	"If you think, O lord, that the horse is not to be released, then let my sire, purified by the constant performance of sacrifices be endowed with the entire fruit of the sacrifice, as if it had been completed in due form.
tavaiva sandeśaharādviśāṃpatiḥ śṛṇoti nākeśa tathā vidhīyatām // Ragh(K)_3.66 //	Moreover, O lord of the worlds, be it so arranged that the lord of the people, seated in the (sacred) chamber and inaccessible, being a part of the three-eyed god, may hear of this incident from your own messenger." 67.
tatheti kāmaṃ pratiśuśruvānraghoryathāgataṃ mātalisārathiryayau / nṛpasya nātipramanāḥ sadogṛhaṃ sudakṣiṇāsūnurapi nyavartata // Ragh(K)_3.67 // tamabhyanandatprathamaprabodhitaḥ prajeśvaraḥ śāsanahāriṇā hareḥ /	Having promised to grant the wish of Raghu, with the words 'so it shall be', Indra (lit. the god having Màtali for his charioteer) went his way; and the son of Sudakshina too, not much pleased at heart, returned to the council-hall of the king. The lord of men, already informed by the messenger of Indra, warmly received him touching his body marked with the wound of the thunderbolt, with a hand benumbed with joy.
iti kṣitīśo navatiṃ navādhikāṃ mahākratūnāṃ mahanīyaśāsanaḥ /	Thus did the lord of the earth, of laudable rule, wishing to ascend heaven, at the close ot his life, accomplish nine-and- ninety great sacrifices, as if he constructed a flight of steps.
atha sa viṣayavyāvṛttātmā yathāvidhi sūnave nṛpatikakudaṃ dattvā yūne sitātapavāraṇam / munivanatarucchāyāṃ devyā tayā saha śiśriye galitavayasāmikṣvākūṇāmidaṃ hi kulavratam // Ragh(K)_3.70 //	And now he, with his mind turned away from the objects of sense, made over in due form to his young son the white umbrella, the emblem of royalty, and betook himself in company with his celebrated queen to the shade of a tree in a forest in- habited by hermits: for this, indeed, was the family vow (pra- ctice,) of the princes of Ikshvàku's race, when in the decline of their life.
sa rājyaṃ guruṇā dattaṃ pratipadyādhikaṃ babhau / dinānte nihitaṃ tejaḥ savitreva hutāśanaḥ // Ragh(K)_4.1 //	Having obtained the kingdom made over by his sire, Raghu shone yet more brilliantly (than before), as does fire (lit. the feeder on oblations) on receiving the effulgence deposited with it by the sun at the close of the day.
nyastaśastraṃ dilīpaṃ ca taṃ ca śuśruvuṣāṃ prabhum / rājñāmuddhṛtanārāce hṛdi śūlamivārpitam // Ragh(K)_4.2 //	On hearing that he was established on the throne after Dilípa, the fire (of jealousy) which had long been thickly smok- ing in the hearts of (hostile) princes, now blazed forth, as it were.
navābhyutthānadarśinyo nananduḥ saprajāḥ prajāḥ // Ragh(K)_4.3 //	His subjects with their children rejoiced to see with beamig rows of eyes his new rise (to the throne), as they would see, with uplifted rows of eyes, the flag hoisted in honour of Indra.
samameva samākrāntaṃ dvayaṃ dviradagāminā /	Two things were simultaneously brought under himself by him who walked with the gait of an elephant (or on elephant- back), viz.
tena siṃhāsanaṃ pitryamakhilaṃ cārimaṇḍalam // Ragh(K)_4.4 //	the paternal throne and the whole circle of his enemies.
chāyāmaṇḍalalakṣyeṇa tamadṛśyā kila svayam / padmā padmātapatreṇa bheje sāmrājyadīkṣitam // Ragh(K)_4.5 //	Him, consecrated to the universal sovereignty, served Padmá (the goddess of regal fortune), as it seemed, herself invisi- ble, by holding over him a lotus-umbrella, discernible from the halo of radiance (that encircled him).
parikalpitasānnidhyā kāle kāle ca vandiṣu / stutyaṃ stutibhirarthyābhirupatasthe sarasvatī // Ragh(K)_4.6 //	And the goddess of learning too, being present in the panegyrizing bards at stated hours, served him, worthy of praise, with eulogies, full of sense.
manuprabhṛtibhirmānyairbhuktā yadyapi rājabhiḥ /	The earth, though enjoyed by estimable monarchs, with Manu at their head, appeared in his case like one that had no previous master (was not enjoyed by any one else before ).
sa hi sarvasya lokasya yuktadaṇḍatayā manaḥ / ādade nātiśītoṣṇo nabhasvāniva dakṣiṇaḥ // Ragh(K)_4.8 //	He, by the justice of his punishments, won the heart of all the people, like the southern breeze, which is neither very cold nor excessively hot ( and therefore delightful to every one).
phalena sahakārasya puṣpodgama iva prajāḥ // Ragh(K)_4.12 //	By his possessing superior virtues the people were made to long less for his father by him just as they are by the fruit of the mango tree for its blossoming.
pañcānāmapi bhūtānāmutkarṣaṃ pupuṣurguṇāḥ /	Even the qualities of the five primary elements (now) attained a (fresh) excellence.
nave tasminmahīpāle sarvaṃ navamivābhavat // Ragh(K)_4.13 //	Under his new regime everything became new, as it were.Canto IV.
pārthivaśrīrdvitīyeva śaratpaṅkajalakṣaṇā // Ragh(K)_4.14// nirvṛṣṭalaghubhirmeghaiḥ savitustasya cobhayoḥ / vardhiṣṇavo diśāṃ bhāgāḥ pratāpāyeva recitāḥ // Ragh(K)_4.15 //	As the moon by its power to delight is rightly called Chandra; and as the sun by its diffusing heat is correctly named Tapana; so he, by pleasing his subjects, was justly styled Rôja. Granted that his eyes were large, extending to the ears; but the function of (real) eyes was discharged in his case by (his knowledge of) the S'ástras, pointing out to him the minute details of his regal duties (or the subtle purposes to be accomplished).
svaṃ dhanuḥ śaṅkiteneva saṃjahre śatamanyunā // Ragh(K)_4.16 //	Now as he was at ease ( happy) by the pacificatition of (establishment of order and peace in ) his kingdom, there came to him, like a second goddess of wealth, autumn, marked by lotuses.
puṇḍarīkātapatrastaṃ vikasatkāśacāmaraḥ / ṛturviḍambayāmāsa na punaḥ prāpa tacchriyam // Ragh(K)_4.17 // prasādasumukhe tasmiṃścandre ca viṣadaprabhe /	Indra withdrew his pluvial bow and Raghu took up his victorious one; for they both took up their respective bows in turn for the good of the people. The (autumnal) season, with its umbrella of white lotuses and with its chauries of the opening Kàsa flowers, imitated Raghu with his lotus-like umbrella and his chauries resembling the bloom- ing Kás a flowers, but could not attain his regal splendour.
tadā cakṣuṣmatāṃ prītirāsītsamarasā dvayoḥ // Ragh(K)_4.18 //	At that time the delight of those who had eyes was of equal flavour (or, ardour) at the sight of him with a sweet smiling face, and of the moon of bright lustre.
haṃsaśreṇiṣu tārāsu kumudvatsu ca vāriṣu / vibhūtayastadīyānāṃ paryastā yaśasāmiva // Ragh(K)_4.19 //	The affluence of his fame seemed to be distributed among the rows of geese, among the starry spheres, and in waters abound- ing in (white) lillies.
ikṣucchāyāniṣādinyastasya gopturguṇodayam / ākumārakathodghātaṃ śāligopyo jaguryaśaḥ // Ragh(K)_4.20 // prasasādodayādambhaḥ kumbhayonermahaujasaḥ /	Women keeping watch over the fields of paddy corn, seated in sugar-cane shades, sang the fame of him, the protector, springing from his merits, beginning from his heroic deeds as a boy (or whereof a beginning was made by even children).
raghostvabhibhavāśaṅki cukṣubhe dviṣatāṃ manaḥ // Ragh(K)_4.21 // madodagrāḥ kakudmantaḥ saritāṃ kūlamudrujāḥ / līlākhelamanuprāpurmahokṣāstasya vikramam // Ragh(K)_4.22 //	At the rise of him sprung from a pitcher (the star of Agastya), of great splendour, water became clear (pure and pellucid); at that of Raghu, of great might, the heart of his enemies apprehensive of defeat, got muddled (roiled). Huge bulls with massive humps, fierce with fury and rend- ing up (battering down) the banks of rivers, imitated the prowess of Raghu, which had much the grace of sport.Canto IV.
prasavaiḥ saptaparṇānāṃ madagandhibhirāhatāḥ / asūyayeva tannāgāḥ saptadhaiva prasusruvuḥ // Ragh(K)_4.23 //	Wounded (in their vanity, or excited) by the rut-scented flowers of the saptaparna trees, Raghu's elephants poured forth, as if in emulation, ichor in all the seven ways (i.e. from all the seven parts of their body).
saritaḥ kurvatī gādhāḥ pathaścāśyānakardamān /	Making the rivers fordable and the roads with their mud dried up, Autumn incited him to an expedition of conquest, before his personal energy (inspired him to do it).
tasmai samyagghuto vahnirvājinīrājanāvidhau / pradakṣiṇārcirvyājena hasteneva jayaṃ dadau // Ragh(K)_4.25 //	At the lustration ceremony of his horses, the sacrificial fire, fed with oblations duly offered, gave him (the blessing of) victory with his own hand, as it were, in the form of the flame turning towards the right (and thus betokening victory).
ṣaḍvidhaṃ balamādāya pratasthe digjigīṣayā // Ragh(K)_4.26 // avākiranvayovṛddhāstaṃ lājaiḥ paurayoṣitaḥ /	Having his capital and the frontier forts well-guarded, and the rear cleared of his foes or with his rear well protected), and attended with good luck, he marched out with a sixfold force for the conquest of the quarters.
pṛṣatairmandaroddhūtaiḥ kṣīrormaya ivācyutam // Ragh(K)_4.27 //	The women of the city, advanced in age, scattered over him fried rice, as the waves of the milky ocean deluged Achyuta with the drops thrown up by Mandara.
sa yayau prathamaṃ prācīṃ tulyaḥ prācīnabarhiṣā /	He, Indra's peer (in valour), first marched towards the east, menacing, as it were, his foes with his flags waved by the wind.
rajobhiḥ syandanoddhūtairgajaiśca ghanasannibhaiḥ / bhuvastalamiva vyoma kurvanvyomeva bhūtalam // Ragh(K)_4.29 //	And turning, as it were, the sky into the earth's surface and the earth's surface, into the sky by means (respectively) of the clouds of dust raised by his chariots and of his elephants resembl. ing clouds.
pratāpo 'gre tataḥ śabdaḥ purogāstadanantaram / yayau paścādgajānīkaṃ catuḥskandheva sā camūḥ // Ragh(K)_4.30 //	His prowess in the van, then the uproar, thereafter the dust, and last of all the chariots and the rest; thus did the army (of Raghu) march forward, consisting of four divisions (corps) as it were.
marupṛṣṭhānyudambhāṃsi nāvyāḥ supratarā nadīḥ / vipināni prakāśāni śaktimattvāccakāra saḥ // Ragh(K)_4.32 //	By reason of his being possessed of power or (resources), he turned deserts into well-watered tracts, the navigable rivers into easily fordable ones, and the forests into open plains (spaces).
sa senāṃ mahatīṃ karṣanpūrvasāgaragāminīm / babhau harajaṭābhraṣṭāṃ gaṅgāmiva bhagīrathaḥ // Ragh(K)_4.33 //	Leading his mighty army marching towards the eastern sea, he looked like Bhagiratha, leading the broad Gangá fallen from the matted hair of S'iva and flowing towards the eastern sea.
tyājitaiḥ phalamutkhātairbhagnaiśca bahudhā nṛpaiḥ / tasyāsīdulbaṇo mārgaḥ pādapairiva dantinaḥ // Ragh(K)_4.34 //	His path was conspicuous by the (hostile) kings made to part with their acquisitions (wealth), dethroned and variouslyCanto IV. ] ( 29 ) routed, like that of a tusker, which is marked by trees, shorn of their fruits, uprooted and destroyed in various ways.
prāpa tālīvanaśyāmamupakaṇṭhaṃ mahodadheḥ // Ragh(K)_4.35 //	Taus overrunning the kingdoms in the east the victor came : to the shore of the great ocean, dark with the forests of tálî trees.
anamrāṇāṃ samuddhartustasmātsindhurayādiva / ātmā saṃrakṣitaḥ suhmairvṛttimāśritya vaitasīm // Ragh(K)_4.36 //	From him the uprooter of all that did not bend before him, as from the current of a river, the Suhmas saved themselves by following the course of cane-plants (adopting the policy of submis- sion).
vaṅgānutkhāya tarasā netā nausādhanoddhatān / nicakhāna jayastambhāngaṅgāsrotontareṣu saḥ // Ragh(K)_4.37 //	Having by his power uprooted the Vanga kings, who had resisted him by means of their ships, he, the leader, planted (memorial) pillars of victory in the intervals of (i.e. the islets between) the streams of the Ganges.
āpādapadmapraṇatāḥ kalamā iva te raghum / phalaiḥ saṃvardhayāmāsurutkhātapratiropitāḥ // Ragh(K)_4.38 //	Like the Kalama plants which bend low to (or to the lotuses at their roots and yield a rich harvest after having been first uprooted and then transplanted, they, first uprooted and then reinstated, bowed down to his lotus-like feet and honoured him by. gifts of riches.
utkalādeśitapathaḥ kaliṅgābhimukho yayau // Ragh(K)_4.39 //	He crossed the river Kapis'â with his troops by means of. a bridge formed of the elephants and marched towards Kalinga, the way being led by the Utkala (Orissa) princes.
sa pratāpaṃ mahendrasya mūrdhni tīkṣṇaṃ nyaveśayat / aṅkuśaṃ dviradasyeva yantā gambhīravedinaḥ // Ragh(K)_4.40 //	He plauted his mighty prowess (made it keenly felt) on the head (peak) of the mountain Mahendra, just as a driver does his sharp goad in the head of a Gambhîravedi (not easily senstive to pain ) elephant.
pratijagrāha kāliṅgastamastrairgajasādhanaḥ / pakṣacchedodyataṃ śakraṃ śilāvarṣīva parvataḥ // Ragh(K)_4.41 //	The king of Kalinga, strong in his war elephants, received him with showers of missiles, as a mountain, showering stones, would (receive ) Indra, prepared to cut its wings.
sanmaṅgalasnāta iva pratipede jayaśriyam // Ragh(K)_4.42 //	Having borne a heavy shower of the enemies' iron- arrows, the descendant of Kakutstha won the goddess of victory, as if after having taken an auspicious bath.
tāmbūlīnāṃ dalaistasya racitāpānabhūmayaḥ / nārikelāsavaṃ yodhāḥ śātravaṃ ca yaśaḥ papuḥ // Ragh(K)_4.44 //	There, his soldiers, having prepared places for wassail, quaffed in (cups of) betel leaves coconut-wine, and also the glory of their enemies.
gṛhītapratimuktasya sa dharmavijayī nṛpaḥ / hriyaṃ mahendranāthasya jahāra na tu medinīm // Ragh(K)_4.45 //	The king, a righteous conqueror, took away the wealth and not the territory of the lord of Mahendra, first made a captive but afterwards released.
tato velātaṭenaiva phalavatpūgamālinā /	Then marching along the sea-coast, lined with betel-nut- trees bearing fruit, he, to whom victory was not a thing to be(30) [Canto IV.
agastyacaritāmāśāmanāśāsyajayo yayau // Ragh(K)_4.46 //	sought after, marched towards the quarter resorted to by Agastya (the south).
sa sainyaparibhogena gajadānasugandhinā / kāverīṃ saritāṃ patyuḥ śaṅkanīyāmivākarot // Ragh(K)_4.47 //	By reason of her enjoyment by his army, redolent of (marked by) the sweet scent of elephants' ichor, he made Kâverf (the river) suspectable (an object of suspicion), as it were, to the lord of the rivers (the Ocean).
balairadhyuṣitāstasya vijigīṣorgatādhvanaḥ / hārītocchiṣṭamaricā malayādrerupatyakāḥ // Ragh(K)_4.49 //	By the forces of him bent on conquest after he had travelled the day's distance, were occupied the adjoining grounds of the mountain Malaya, where the Hârfta birds (parrots of a parti- cular kind) were flying about in the forests of peppers.
ājāneyakhurakṣuṇṇapakvailākṣetrasambhavam / vyānaśe sapadi vyoma kīṭakośābilaṃ rajaḥ // Ragh(K)_4.50 // bhogiveṣṭanamārgeṣu candanānāṃ samarpitam / nāsraṃsatkariṇāṃ graivaṃ tripadīchedināmapi // Ragh(K)_4.51 //	The dust of the fruits of the cardamom plants pounded by (the hoofs of) his horses, flying up, clung to (settled on) the temples of the infuriated elephants, exhaling a similar smell. The neck-chains of the elephants powerful enough to break down even the foot-chains, did not slip off, being tied round the lines of grooves (deppressions) made by the collings of snakes into the sandal trees.
tasyāmeva raghoḥ pāṇḍyāḥ pratāpaṃ na viṣehire // Ragh(K)_4.52 //	Even the splendour (heat) of the sun is dimmed (mitigated) when in the southern quarter; but in that very quarter the Pândya princes could not bear the burning prowess of Raghu.
tāmraparṇīsametasya muktāsāraṃ mahodadheḥ / te nipatya dadustasmai yaśaḥ svamiva sañcitam // Ragh(K)_4.53 //	Bowing down (at his feet) they presented to him the finest pearls found at the place where the Tàmraparni falls into the great ocean, their own accumulated glory, as it were.
sa nirviśya yathākāmaṃ taṭasvādhīnacandanau / stanāviva diśastasyāḥ śailau malayadurdurau // Ragh(K)_4.54 // asahyavikramaḥ sahyaṃ dūramuktamudanvatā / nitambamiva medinyāḥ srastāṃśukamalaṅghayat // Ragh(K)_4.55 //	Having enjoyed to the satisfaction of his wish the mountains Malaya and Dardura, with sandal trees covering their skirts, as if they were the breasts of the quarter with sandal paste applied to their sides, he, of irresistible prowess, crossed (or, reached) the Sahya mountain, far left off by the sea, the rump of the earth, as it were, with its vesture slipped off. On account of his forces marching along, prepared to conquer the countries of the west, the sea, though far removed by the missile of Paras urâma, seemed to be connected with the mountain Sahya.
tasyānīkairvisarpadbhiraparāntajayodyataiḥ / rāmeṣūtsārito 'pyāsītsahyalagna ivārṇavaḥ // Ragh(K)_4.56 //	The dust raised by the army was placed by him, as a substitute for the hair-powder, on the curls of the Kerala ladies who had given up personal decorations in terror.
marmaraḥ pavanoddhūtarājatālīvanadhvaniḥ // Ragh(K)_4.58 // kharjūrīskandhanaddhānāṃ madodgārasugandhiṣu / kaṭeṣu kariṇāṃ petuḥ punnāgebhyaḥ śilīmukhāḥ // Ragh(K)_4.59 //	The pollen of the Ketaka flowers, wafted by breezes from the Muralâ, served as a scented powder obtained without effort for the armours of his warriors.Canto IV. The rustling of the large palm forests shaken by the wind was drowned by the clank of armours on the bodies of his war- horses moving about. The black bees deserting the Punnâga trees fell upon the temples scented with the flow of the ichor of elephants tied to the trunks of the date trees.
aparāntamahīpālavyājena raghave karam // Ragh(K)_4.60 //	History has it that the ocean gave space to Ráma on being requested by him; but to Raghu, it gave tribute under the disguise of the western kings.
mahebharadanotkīrṇavyaktavikramalakṣaṇam / trikūṭameva tatroccairjayastambhaṃ cakāra saḥ // Ragh(K)_4.61 //	There he turned the Trikita itself into a lofty pillar of victory, bear as it did the distinct record of his military valour in the form of the incisions of the tusks of his infuriated elephants.
pārasīkāṃstato jetuṃ pratasthe sthalavartmanā / indriyākhyāniva ripūṃstattvajñānena saṃyamī // Ragh(K)_4.62 //	Thereafter he set out by a land-route to conquer the Per- sians, as a man possessed of self-control proceeds, with the help of the knowledge of truth, to subdue the foes known as the senses (passions.) 61.
yavanīmukhapadmānāṃ sehe madhumadaṃ na saḥ / bālātapamivābjānāmakālajaladodayaḥ // Ragh(K)_4.63 //	He did not bear the flush imparted by liquor to the lotus- like faces of the Yavana dames, just as an untimely rise of clouds does not (bear i.e. intercepts) the morning sunlight on (tinging) the lotuses.
saṅgrāmastumulastasya pārasīkāśvasādhanaiḥ / śārṅgakūjitavijñeyapratiyodho rajasyabhūt // Ragh(K)_4.64 //	A fierce battle took place between him and the Yavanas of the west, whose army consisted of cavalry, in the midst of dust (raised by the armies) so (dense) that the opposing warriors could know each other simply by the twang of their bows.
bhallāpavarjitaisteṣāṃ śirobhiḥ śmaśrulairmahīm /	He strewed the earth with their bearded heads, severed by means of Bhallas (arrows having broad blades) as if with so many honey-combs covered with bees.
apanītaśirastrāṇāḥ śeṣāstaṃ śaraṇaṃ yayuḥ /	The rest (i.e. survivors) took off their helmets and sought his protection; for the wrath of the high-minded is appeased by humble submission (lit. has submission for its remedy).
āstīrṇājinaratnāsu drākṣāvalayabhūmiṣu // Ragh(K)_4.67 //	His soldiers removed the fatigue of victory by means of wine, in vine-yards (lit. grounds covered with bowers of vine) with the finest deer-skins spread thereon.
tataḥ pratasthe kauberīṃ bhāsvāniva raghurdiśam / śarairusrairivodīcyānuddhariṣyanrasāniva // Ragh(K)_4.68 //	Then Raghu marched towards the quarter of Kubera (the north) with the desire of uprooting, by means of his arrows, the northern kings, just as the great luminary (sun) passes north- wards in order to suck up moisture with his rays.(32.) [ Canto IV.
vinītādhvaśramāstasya vaṅkṣutīraviveṣṭanaiḥ / dudhuvurvājinaḥ skandhāṃllagnakuṅkumakesarān // Ragh(K)_4.70 //	His horses having the fatigue of their journey relleved by rolling on the bank of the Sindhu, shook their shoulders to which were adhering the filaments of saffron (or, the manes of which had safforn sticking to them).
tatra hūnāvarodhānāṃ bhartṛṣu vyaktavikramam / kapolapāṭanādeśi babhūva raghuceṣṭitam // Ragh(K)_4.71 //	There the exploits of Raghu, the prowess whereof was displayed on the husbands of the Hapa ladies, became a teacher of ruddiness in the cheeks to them (or came to have the redness of their cheeks for a record).
kāmbojāḥ samare vīryaṃ tasya soḍhumanīśvarāḥ / gajālānaparikliṣṭairakṣoṭaiḥ sārdhamānatāḥ // Ragh(K)_4.72 //	The Kâmboja princes, unable to stand his valour in battle, bent low (before him) together with the walnut trees strained (injured) all round by the fastening (or fastesing-chains.) of his elephants.
teṣāṃ sadaśvabhūyiṣṭhāstuṅgā draviṇarāśayaḥ /	Lofty (stupendous) heaps of riches, abounding in noble steeds, reached the lord of the Kosalas every day; but not their boastful manners (or, 'but pride never touched him').
tato gaurīguruṃ śailamāruroha sasādhanaḥ /	Then he ascended the mountain Himalaya (Gauri's father) with his cavalry, augmenting, in size, as it were, its peaks by the mineral dust raised up (by his horses).
vardhayanniva tatkūṭānuddhatairdhātureṇubhiḥ // Ragh(K)_4.74 // praśaṃsaṃstulyasattvānāṃ sainyaghoṣe 'pyasambhramam /	The gaze, by turning back (their necks), of the lions lying in their dens and of equal might (with the army), indicated absence of agitation (or fear) on their part (their intrepidity) even in the midst of the din (tumult) of the army.
gaṅgāśīkariṇo mārge marutastaṃ siṣevire // Ragh(K)_4.76 //	Breezes, rustling among the birch trees, the cause of the musical sounds of the singing bamboos, and charged with the spray of the Ganges, ministered to (fanned) him on the way.
viśaśramurnamerūṇāṃ chāyāsvadhyāsya sainikāḥ /	His soldiers took rest under the shade of the Nameru trees, sitting on stone-slabs with their surfaces perfumed with the pavel (musk) of the musk-deer squatting upon them.
saralāsaktamātaṅgagraiveyopacitatviṣaḥ / āsannoṣadhayo neturnaktamasnehadīpikāḥ // Ragh(K)_4.78 //	The lustrous berbs with their light reflected from the iron neck-chains of the elephants tied to the Sarala trees, served, at night, as lamps (that burnt) without oil, to him, the leader of the forces.
tasyāvāseṣu dānārdrairgaṇḍabhittivighaṭṭanaiḥ / gajavarṣma kirātebhyaḥ śaśaṃsurdevadāravaḥ // Ragh(K)_4.79 //	In the halting places left by him, the devada ru trees, the bark of which was rubbed off by the neck-ropes (with which the elephants were tied to them) indicated to the Kira'tas the height of his elephants.
vimardaḥ saha taistatra pārvatīyairabhūdraghoḥ / nārācakṣepaṇīyāśmaniṣpeṣotpatitānalaḥ // Ragh(K)_4.80 //	There a fierce battle took place between him and the mountain tribes, in which fire flashed forth as the iron darts and the stones flung by means of slings clashed together.Canto IV.
śarairutsavasaṅketānsa kṛtvā karadānkṛtī / jayodāharaṇaṃ bāhvorgāpayāmāsa kinnarān // Ragh(K)_4.81 //	Having made the Utsavasamketas destitute of their festivi- ties by means of his arrows, he caused the Kimnaras to sing the songs descriptive of the victory of ( won by) his arms.
rājñā himavataḥ sāro rājñaḥ sāro himādriṇā // Ragh(K)_4.82 //	When they approached ( him), presents in hand, these came to be mutually known, Himavat's strength (wealth) by the king and the King's strength ( prowess) by Himádri ( the snowy mountain).
tatrākṣobhyaṃ yaśorāśiṃ niveśyāvaruroha saḥ / paulastyatulitasyādrerādadāna iva hriyam // Ragh(K)_4.83 //	Having established there the unshakable (or irrefragable) mass of his glory, he descended (from the mountain), causing shame, as it were, to the mountain that was balanced ( being uplifted) by Paulastya (Rávaṇa )—i.e. Kailása.
tadgajālānatāṃ prāptaiḥ saha kālāgurudrumaiḥ // Ragh(K)_4.84 //	When he crossed the Lauhityá the lord of the Prágjyo- tishas quaked (with fear), as also did the black aloe-wood trees got to the condition of (used as) tie-posts for his elephants.
na prasehe sa ruddhārkamanabhramayadurdinam / rathavaṃśarajo 'pyasya kuta eva patākinīm // Ragh(K)_4.85 //	He could not bear even the dust raised from the track of his charlots, which hid the sun and which looked like a cloudy day (atmosphere) without a shower; how could he face his army? 83.
bheje bhinnakaṭairnāgairanyānuparurodha yaiḥ // Ragh(K)_4.86 //	The king of the Kâmarúpas waited upon him whose valour exceeded that of Indra himself, with those very elephants, with ripped ichor-shedding temples, with which he had resisted (or repulsed) others.
kāmarūpeśvarastasya hemapīṭhādhidevatām / ratnapuṣpopahāreṇa cchāyāmānarca pādayoḥ // Ragh(K)_4.87 //	The lord of Kamarupas adored the lustre of Raghu's feet, the presiding goddess of the golden foot-stool, with offerings of flowers in the form of gems.
iti jitvā diśo jiṣṇurnyavartata rathoddhatam /	Having thus conquered all the quarters, the conqueror turned back, making the dust raised by his chariots rest on the heads of the kings (now) stripped of the regal umbrellas.
sa viśvajitamājahre kratuṃ sarvasvadakṣiṇam / ādānaṃ hi visargāya satāṃ vārimucāmiva // Ragh(K)_4.89 //	He performed the Visvajit sacrifice in which one's entire wealth is given away as Dakshina'; for of the good as of clouds, acquisition is for distribution.
sattrānte sacivasakhaḥ puraskriyābhirgurvībhiḥ śamitaparājayavyalīkān / kākutsthaściravirahotsukāvarodhān rājanyānsvapuranivṛttaye 'numene // Ragh(K)_4.90 // te rekhādhvajakalaśātapatracihnaṃ samrājaścaraṇayugaṃ prasādalabhyam /	At the end of the sacrifice, the descendant of Kakutstha (Raghu), assisted by his ministers of state, allayed the wounded feelings of the defeated kings by honouring them with marks of great respect, and permitted them to go back to their capitals, where their wives were longing (for their return) owing to their long absence. They, at the time of their departure, bowed down to the emperor's pair of feet bearing linear marks of banners, swords, and R. T.
prasthānapraṇatibhiraṅgulīṣu cakrurmaulisrakcyutamakarandareṇugauram // Ragh(K)_4.91 //	5(34) [ Canto V. royal umbrellas, and accessible by his favour alone, and made them yellowish white at the toes, with the pollen and honey that dropped from the garlands on their heads.
tamadhvare viśvajiti kṣitīśaṃ niḥśeṣaviśrāṇitakośajātam / upāttavidyo gurudakṣiṇārthī kautsaḥ prapede varatantuśiṣyaḥ // Ragh(K)_5.1 //	Then there came to the monarch (Raghu) who had given away, so as to leave no remainder, his wealth of every kind (or his whole treasure) in the Visvajit sacrifice, Kautsa, the disciple of Varatantu, who had acquired learning (finished his education) and whose purpose it was to get money to pay his teacher (as tuition fees; or, seeking to obtain money fo rremunerating his preceptor ).
sa mṛṇmaye vītahiraṇmayatvātpātre nidhāyārghyamanarghaśīlaḥ / śrutaprakāśaṃ yaśasā prakāśaḥ pratyujjagāmātithimātitheyaḥ // Ragh(K)_5.2 // tamarcayitvā vidhivadvidhijñastapodhanaṃ mānadhanāgrayāyī / kṛtāñjaliḥ kṛtyavicāradakṣo viśāmpatirviṣṭarabhājamāha // Ragh(K)_5.3 //	On account of the (stock of his) gold vessels being exhausted' he, of priceless (inestimable, noble) character, bright with glory, and hospitable, having placed the materials of worship in an eartheu pot, went forth to receive the guest radiant (illustrious) with his Vedic knowledge. The lord of men, adept (or versed) in duty and the rules of action (prescribed by the S'àstras) and foremost among those to whom honour is wealth, having worshipped, in the proper form, the guest, who regarded penance as his wealth and who was sitting on a seat, thus addressed him with joined palms, remaining close by.
apyagraṇīrmantrakṛtāmṛṣīṇāṃ kuśāgrabuddhe kuśalī guruste / yatastvayā jñānamaśeṣamāptaṃ caitanyamugrādiva dīkṣitena // Ragh(K)_5.4 //	O you of acute intellect (lit. whose intellect is as acute as the sharp end of a blade of Kus'a grass), is it all well with your preceptor, the foremost of the sages, the composers (or receipients) of the Vedic hymus, from whom you have acquired complete knowledge, as the world derives its animation (or vitality) from the sun ? 5.
kāyena vācā manasā ca taptaṃ yadvajriṇo dhairyaviparyayāya / āpādyate na vyayamantarāyaiḥ kaccinmaharṣestrividhaṃ tapastat // Ragh(K)_5.5 //	I hope the threefold penance of the great sage, which has long been treasured up (by him) by (the exercise of) his body, speech, and mind, and which disturbs (or shakes off) the stability of Indra's mind, suffers no diminution (is not spent up ) by impediments ( requiring its use ).
ādhārabandhapramukhaiḥ prayatnaiḥ saṃvardhitānāṃ sutanirviśeṣam / kaccinna vāyvādirupaplavo vaḥ śramacchidāmāśramapādapānām // Ragh(K)_5.6 //	I hope no calamity, such as a hurricane, visits (befalls) the trees of your hermitage, which beguile fatigue and which have been reared up without distinction with (just like) your sons with efforts, such as the construction of water-basins and others. Are those offspings of the female deer all right, whose desire to eat the Kus'a grass, the hermits, from affection, do not foil (f.
kriyānimitteṣvapi vatsalatvādabhagnakāmā munibhiḥ kuśeṣu /	indulge) even though it is necessary for sacred rites andCanto V.
tadaṅkaśayyācyutanābhinālā kaccinmṛgīṇāmanaghā prasūtiḥ // Ragh(K)_5.7 //	] (35) whose umbilical cords drop down on their laps serving (the fawns) as beds? 8. I hope it is all right with your sacred waters wherein your daily ablutions are performed, from which handfuls of libations.
tānyuñchaṣaṣṭhāṅkitasaikatāni śivāni vastīrthajalāni kaccit // Ragh(K)_5.8 //	are presented to the manes, and whose saudy banks are marked with the sixth part of the gleanings (gleaned corn).
nīvārapākādi kaḍaṅgarīyairāmṛṣyate jānapadairna kaccit / kālopapannātithibhāgadheyaṃ vanyaṃ śarīrasthitisādhanaṃ vaḥ // Ragh(K)_5.9 //	I hope the ripe níva'ra and other corn, the sylvan means of the sustenance of your bodies, out of which portions are allotted to the guests coming in time, is not eaten up by country cattle (accustomed to eat chaff).
api prasannena maharṣiṇā tvaṃ samyagvinīyānumato gṛhāya / kālo hyayaṃ saṅkramituṃ dvitīyaṃ sarvopakārakṣamamāśramaṃ te // Ragh(K)_5.10 //	Has the great sage, being pleased after he had well edu- cated you, permitted you to lead the house-holder's life? For it is now time for you to enter on the second stage of life which is capable of benefiting all the other three (or which enables one to oblige every body).
tavārhato nābhigamena tṛptaṃ mano niyogakriyayotsukaṃ me / apyājñayā śāsiturātmanā vā prāpto 'si sambhāvayituṃ vanānmām // Ragh(K)_5.11 //	My mind is not satisfied by the (mere) coming of you, adorable one, (but) it longs to execute some command (of yours); is it at your preceptor's bidding or of your own accord that you have come to honour me (do me the honour of a visit) from the forest? 12.
ityarghyapātrānumitavyayasya raghorudārāmapi gāṃ niśamya / svārthopapattiṃ prati durbalāśaḥ pratyāha kautsastamapetakutsam // Ragh(K)_5.12 //	Although he heard the noble words of Raghu, whose gift (or expenditure) of his whole wealth was inferred from the vessel containing the materials of worship, the disciple of Varatantu, having but a feeble hope of success in his object, thus addressed him.
sarvatra no vārttamavaihi rājannāthe kutastvayyaśubhaṃ prajānām /	Know, O king, it is all well with us in all respects.
sūrye tapatyāvaraṇāya dṛṣṭeḥ kalpeta lokasya kathaṃ tamisrā // Ragh(K)_5.13 //	How can woe betide the subjects while you are king (or, their protector)? How can the dark night (or a dense mass of darkness) obstruct the sight of men while the sun is shining? 14.
bhaktiḥ pratīkṣyeṣu kulocitā te pūrvānmahābhāgatayātiśeṣe /	Reverence for (or attention to) those worthy of honour is customary with your race (or is the hereditary possession of your dynasty); but, O illustrious one (or O great monarch), you outdo your ancestors in that.
vyapetakālastvahamabhyupetastvāmarthibhāvāditi me viṣādaḥ // Ragh(K)_5.14 //	I, however, have come to you as a suitor out of (the proper) time, and hence my regret.
śarīramātreṇa narendra tiṣṭhannābhāsi tīrthapratipāditarddhiḥ / āraṇyakopāttaphalaprasūtiḥ stambena nīvāra ivāvaśiṣṭaḥ // Ragh(K)_5.15 // sthāne bhavānekanarādhipaḥ san akiñcanatvaṃ makhajaṃ vyanakti /	O lord of men, having bestowed all your wealth on worthy recipients, you appear with your body only remaining to you, like a niva'ra plant having its corn appropriated by foresters (forest- living ascetics) and its stalk (or culm) only left to it. It is but proper (or creditable to you, or becoming in you) that you, though a paramount king, should exhibit poverty (lit.(36) [ Canto V. a state of having nothing) born of (the result) of a sacrifice; for the waning of the moon (whose nectar is) drunk in their turns by gods is more to her praise than her waxing.
tadanyatastāvadananyakāryo gurvarthamāhartumahaṃ yatiṣye /	I, therefore, who have no other business in view, will strive to obtain money for my preceptor from some other source; may you fare well.
svastyastu te nirgalitāmbugarbhaṃ śaradghanaṃ nārdati cātako 'pi // Ragh(K)_5.17 //	Even the cha' taka bird troubles not (with its petitioning) the autumnal cloud whose watery contents are all discharged.
etāvaduktvā pratiyātukāmaṃ śiṣyaṃ maharṣernṛpatirniṣidhya / kiṃ vastu vidvangurave pradeyaṃ tvayā kiyadveti tamanvayuṅkta // Ragh(K)_5.18 //	Dissuading (from going) the disciple of the great sage, who was desirous of going away, after having said this much, the king asked him, "Learned sir! What thing and how much of it is to be presented by you to your preceptor? 19.
tato yathāvadvihitādhvarāya tasmai smayāveśavivarjitāya / varṇāśramāṇāṃ gurave sa varṇī vicakṣaṇaḥ prastutamācacakṣe // Ragh(K)_5.19 //	Then to the ruler of the (four) classes and the stages of life, who had duly performed a sacrifice and who was entirely free from the influence of vanity, the learned ascetic (thus) expressed his purpose (immediate business)- 20.
avāptavidyena mayā maharṣirvijñāpito 'bhūdgurudakṣiṇāyai /	"The great sage was requested by me, when I had completed my course of study, to accept from me preceptor's fee.
sa me cirādaskhalitopacārāṃ tāṃ bhaktimevāgaṇayatpurastāt // Ragh(K)_5.20 //	He, how- ever, counted (regarded) foremost (held more important than, or considered the best, fee) my long and unswerving devotion to him of that kind (so difficult to be performed ).
vittasya vidyāparisaṅkhyayā me koṭīścatasro daśa cāhareti // Ragh(K)_5.21 //	Incensed at my importunities, my preceptor, without taking into consideration the scantiness of my meaus, said to me: "Bring me four-and-ten crores of money (gold coins) corresponding to the number of lores (studied) by you." 22.
so 'haṃ saparyāvidhibhājanena matvā bhavantaṃ prabhuśabdaśeṣam / abhyutsahe samprati noparoddhumalpetaratvācchrutaniṣkrayasya // Ragh(K)_5.22 //	Thus circumstanced I, concluding from your vessel of offerings that you have only the title of sovereign remaining to you, have not the mind to constrain you at present, on account of the price of my learning being other than (far from) low (i.e., very exorbitant or heavy)." 23.
itthaṃ dvijena dvijarājakāntirāvedito vedavidāṃ vareṇa /	Thus informed by the twice-born (Bráhmana), the best of Vedic scholars, the sole lord of the world, fair as the moon, and with the propensities of bis seases restrained from sin, once more spoke to him.
gurvarthamarthī śrutapāradṛśvā raghoḥ sakāśādanavāptakāmaḥ / gato vadanyāntaramityayaṃ me mā bhūtparīvādanavāvatāraḥ // Ragh(K)_5.24 //	"A certain suitor who asked money for his preceptor and who had seen the end (was master) of learning, went to another donor, not obtaining his object from Raghu"-let there not be this new (or for the first time) reproach on my name.
sa tvaṃ prayaste mahito madīye vasaṃścaturtho 'gnirivāgnyagāre /	You, therefore (lit. thus circumstanced), O venerable one, be pleased to wait, like a fourth fire, in my well-known and reveredCanto V.
dvitrāṇyahānyarhasi soḍhumarhanyāvadyate sādhayituṃ tvadartham // Ragh(K)_5.25 //	] (37) sanctuary of (holy) fires, for two or three days, in which time I will endeavour to fulfil your object.
tatheti tasyāvitathaṃ pratītaḥ pratyagrahītsaṅgaramagryajanmā / gāmāttasārāṃ raghurapyavekṣya niṣkraṣṭumarthaṃ cakame kuverāt // Ragh(K)_5.26 //	With the words 'Be it so' the Brahmapa, being delighted, accepted his unfailing promise. Raghu, on his part, seeing that the earth was drained of all its wealth, wished to wrench (thought of procuring by force) money from Kubera.
vasiṣṭhamantrokṣaṇajātprabhāvādudanvadākāśamahīdhareṣu / marutsakhasyeva balāhakasya gatirvijaghne na hi tadrathasya // Ragh(K)_5.27 //	By virtue of the miraculous power accruing from. Vasish- tha's sprinkling accompanied by holy incantations (at the time of his coronation), the course of his chariot, like that of a cloud assisted by the wind, was not obstructed, whether on the sea, or in the sky, or on the mountains.
athādhiśiśye prayataḥ pradoṣe rathaṃ raghuḥ kalpitamastragarbham / sāmantasambhāvanayaiva dhīraḥ kailāsanāthaṃ tarasā jigīṣuḥ // Ragh(K)_5.28 //	Then in the evening Ragħu, firm-minded and pious, slept in his chariot in the interior of which weapons were arranged, desirous of conquering the lord of Kailása (Kubera) by his prowess, looking upon him as (as if he were no better than) a feudatory prince.
prātaḥ prayāṇābhimukhāya tasmai savismayāgantumudo niyuktāḥ /	At dawn, officers, employed in the treasury, full of wonder, reported to him, about to setfourth, a shower of gold fallen from the sky into the treasury-house.
dideśa kautsāya samagrameva pādaṃ sumeroriva vajrabhinnam // Ragh(K)_5.30 //	The king gave to Kautsa the whole of that glittering heap of gold which was obtained from Kubera, who was about to be attacked, and which looked like an adjoining hill of the (mountain) Sumeru detached by Indra's thunder-bolt.
janasya sāketanivāsinastau dvāvapyabhūtāmabhinandyasattvau / gurupradeyādhikaniḥspṛho 'rthī nṛpo 'rthikāmādadhikapradaśca // Ragh(K)_5.31 //	Both of them, the suitor who would not take (lit. who had no desire to accept) more than what was to be given to his preceptor, and the king who gave more than what was asked by the suitor, had the greatness of their mind (or their conduct) greatly praised by the people inhabiting Sâketa (Ayodhyà).
athoṣṭravāmīśatahāritārthaṃ prajeśvaraṃ prītamanā manīṣī / spṛśankareṇānatapūrvakāyaṃ samprasthito vākyamuvāca kautsaḥ // Ragh(K)_5.32 //	Then at his departure, the great sage Kautsa, delighted in the mind, touched by the hand the king who had caused his treasure to be transported (or conveyed) by hundreds of camels and mares, as he bent the forepart of his body before him, and addressed him (this) speech- 33.
kimatra citraṃ yadi kāmasūrbhūrvṛttasthitasyādhipateḥ prajānām / acintanīyastava tu prabhāvo manīṣitaṃ dyaurapi yena dugdhā // Ragh(K)_5.33 //	What wonder is there (i.e. it is no wonder ) if the earth yields the desires of a monarch who abides by his duty? But in- comprehensible is your power, since by you even heaven itself was milked (made to grant) your desired object.
āśāsyamanyatpunaruktabhūtaṃ śreyāṃsi sarvāṇyadhijagmuṣaste /	Any other benediction (than that of issue) would be a repetition (superfluous) to you who have attained all blessings.(38) [ Canto V.
putraṃ labhasvātmaguṇānurūpaṃ bhavantamīḍyo bhavataḥ piteva // Ragh(K)_5.34 //	May you obtain a son worthy of your excellences, as your father obtained your praiseworthy self.
itthaṃ prayujyāśiṣamagryajanmā rājñe pratīyāya guroḥ sakāśam /	Having thus conferred a blessing upon the king, the Brâh- mana returned to his preceptor.
rājāpi lebhe sutamāśu tasmād ālokamarkādiva jīvalokaḥ // Ragh(K)_5.35 //	The king, too, soon after, obtained a son from it (by virtue of it, scil. the blessing) as the world of the living receives light from the sun.
brāhme muhūrte kila tasya devī kumārakalpaṃ suṣuve kumāram /	At the hour presided over by Brahmâ, history records (f), his queen gave birth to a son like Kumâra.
ataḥ pitā brahmaṇa eva nāmnā tamagryajanmānamajaṃ cakāra // Ragh(K)_5.36 //	On that account the father made (called) his son Aja, after the name of Brahmå himself.
rūpaṃ tadojasvi tadeva vīryaṃ tadeva naisargikamunnatatvam / na kāraṇātsvādbibhide kumāraḥ pravartito dīpa iva pradīpāt // Ragh(K)_5.37 //	His majestic (or resplendent) form was the same, the valour the same, and the natural sublimity (or nobleness of nature) also the same; the new-born prince did not differ from his (generating cause (father) as a lamp lighted from another (does not differ from it.) 38.
śrīḥ kāmayānāpi guroranujñāṃ dhīreva kanyā piturācakāṅkṣa // Ragh(K)_5.38 // atheśvareṇa krathakaiśikānāṃ svayaṃvarārthaṃ svasurindumatyāḥ / āptaḥ kumārānayanotsukena bhojena dūto raghave visṛṣṭaḥ // Ragh(K)_5.39 //	The goddess of royalty, though she had a yearning after him when he had duly received his education from his precep tors and was looking all the more charming (or peculiarly charm- ing) by reason of his blooming youth, waited for her master's (or his sire's) permission, as a discreet, noble-minded daughter does for her father's. About this time, a trusty messenger was sent to Raghu by Bhoja, lord of the Krathakais'ikas, who was ardently desirous of bringing the prince (Aja) for (to be present at the ceremony of the self-election-marriage of his sister Indumatf.
taṃ ślāghyasambandhamasau vicintya dārakriyāyogyadaśaṃ ca putram / prasthāpayāmāsa sasainyamenamṛddhāṃ vidarbhādhiparājadhānīm // Ragh(K)_5.40 //	Considering him to be one with whom a connexion was desirable and (further) that his son had arrived at a marriageable age, he sent him with an army to the flourishing (or wealthy) capital of the king of the Vidarbhas.
tasyopakāryāracitopakārā vandhyetarā jānapadopadhābhiḥ / mārge nivāsā manujendrasūnorbabhūvurudyānavihārakalpāḥ // Ragh(K)_5.41 //	The halting stations on the way of him, a king's son, in which accommodations of all kinds were provided in tents of royal state, and which, on account of the presents brought by the villagers, appeared other than the reverse of) sylvan, were almost like places of amusement in gardens.
athopariṣṭādbhramarairbhramadbhiḥ prāksūcitāntaḥsalilapraveśaḥ / nirdhautadānāmalagaṇḍabhittirvanyaḥ saritto gaja unmamajja // Ragh(K)_5.43 // apyaughavikṣālitagairikeṇa vaprakriyāmṛkṣavatastaṭeṣu /	When he had gone over some way (certain distance) he encamped his wearied army, with its banners sullied with dust, on the bank of the Narmadâ, the naktama'la trees on which were made to dance a little (gently shaken) by the breezes charged with spray (or moist with the drops of water ).Canto V. Just then there emerged from the river a wild elephant, whose plunge (lit. entrance) into the water had already been indicated by black bees hovering above (over the surface of the water) and whose expansive cheeks were clean, as the ichor had been entirely washed off.
nīlordhvalekhāśavalena śaṃsandantadvayenāśmavikuṇṭhitena // Ragh(K)_5.44 //	Who betrayed his butting-sports on the skirts of the Rikshavat mountain by means of his two rock-blunted tusks, which were checkered with blue lines running upwards, although completely washed of all mineral dust.
saṃhāravikṣepalaghukriyeṇa hastena tīrābhimukhaḥ saśabdam / babhau sa bhindansahasā taraṅgānvāryargalābhaṅga iva pravṛttaḥ // Ragh(K)_5.45 //	As he faced the bank and cut (his way) with (loud) noise (through) the large waves with his trunk quick in its contractions and protrusions, he looked as if engaged in breaking asunder the bolts of his stall. The mountain-like elephant dragging with him by his breast the meshes of moss (s'aivala) reached the bank afterwards, the current of waters violenty agitated by him having reached it first.
tasyaikanāgasya kapolabhittyorhradāvagāhakṣaṇamātraśāntā / vanyetarānekapadarśanena punardidīpe madadurdinaśrīḥ // Ragh(K)_5.47 //	The darkish splendour of the ichor flowing from the broad cheeks of that one (single of its kind, chief &c. ) elephant, which had been stopped for a moment by his plunge into water, shone forth afresh at the sight of tame (lit. other than wild) elephants..
saptacchadakṣīrakaṭupravāhamasahyamāghrāya madaṃ tadīyam / vilaṅghitādhoraṇatīvrayatnāḥ senāgajendrā vimukhā babhūvuḥ // Ragh(K)_5.48 //	On smelling his unbearable rut whose flow was as strong- smelling (or fragrant) as the milky exudation of the saptachchhada (seven-leaved) tree, the huge elephants in the army turned back (shied), notwithstanding (or defying) the strenuous efforts of their drivers.
sa cchinnabandhadrutayugyaśūnyaṃ bhagnākṣaparyastarathaṃ kṣaṇena / rāmāparitrāṇavihastayodhaṃ senāniveśaṃ tumulaṃ cakāra // Ragh(K)_5.49 //	In a moment he threw the encampment into utter confu- sion, cleared of horses which tore their bonds and fled, with the chariots fallen to the ground, their axles being broken and with the warriors perplexed in protecting the ladies.
nivartayiṣyanviśikhena kumbhe jaghāna nātyāyatakṛṣṭaśārṅgaḥ // Ragh(K)_5.50 // sa viddhamātraḥ kila nāgarūpamutsṛjya tadvismitasainyadṛṣṭaḥ / sphuratprabhāmaṇḍalamadhyavarti kāntaṃ vapurvyomacaraṃ prapede // Ragh(K)_5.51 //	The prince, who knew (from the S'âstras) that a king ought not to kill a wild elephant, not drawing his horn-made-bow to any great length, struck the rushing elephant on the forehead with an arrow, ( merely) wishing to make him turn back. The moment he was wounded, as history tells us, he quitted the from of an elephant, and assumed the lovely figure of a heavenly being, encircled with a flashing halo of light, and looked at by the army astonished at the (curious ) occurrence.
atha prabhāvopanataiḥ kumāraṃ kalpadrumotthairavakīrya puṣpaiḥ /	Then having showered on the prince the flowers of the heavenly trees that came to him through his superhuman power,(40) [Canto V.
mataṅgaśāpādavalepamūlādavāptavānasmi mataṅgajatvam / avaihi gandharvapatestanūjaṃ priyaṃvadaṃ māṃ priyadarśanasya // Ragh(K)_5.53 //	the eloquent one (thus) spoke, enhancing with the lustre of his teeth the (brightness of the ) necklace of large pearls pendant on his bosom. I was reduced to the state of an elephant by the curse of Matanga, incurred by my own arrogance. Know me to be Priyamvada, the son of Priyadars ana, king of the Gandharvas.
sa cānunītaḥ praṇatena paścānmayā maharṣirmṛdutāmagacchat / uṣṇatvamagnyātapasamprayogācchaityaṃ hi yatsā prakṛtirjalasya // Ragh(K)_5.54 //	The great sage, however, being supplicated by me falling at his feet, relented afterwards; for the hotness of water is due to its contact with fire or solar heat; what is coldness is but the nature (natural property) of water.
ikṣvākuvaṃśaprabhavo yadā te bhetsyatyajaḥ kumbhamayomukhena / saṃyokṣyase svena punarmahimnā tadetyavocatsa taponidhirmām // Ragh(K)_5.55 //	"When Aja, sprung from the family of Ikshvàku, will split thy frontal globe with his iron-pointed shaft, then shalt thou be united with (restored to) thy magnificent form "-so spoke that repository of penance (the great sage) to me. I have been liberated from the curse by you endowed with might, whose sight had long been earnestly wished for by me.
pratikriyāṃ cedbhavato na kuryāṃ vyarthā hi me syātsvapadopalabdhiḥ // Ragh(K)_5.56 //	If I do you no good in return, my restoration to my proper position is all to no purpose.
gāndharvamastraṃ taditaḥ pratīccha prayogasaṃhāravibhaktamantram / prasvāpanaṃ nāma yataḥ praharturna cārihiṃsā vijayaśca haste // Ragh(K)_5.57 //	Accept, therefore, O friend, this missile of mine, 'Sammo- hana (the stupifier)' by name, which has a Gandharva for its presiding deity, and has separate incantations for its discharge and withdrawal whereby the discharger has victory in his hand (sure in his possession) and yet has not to kill enemies.
alaṃ hriyā māṃ prati yanmuhūrtaṃ dayāparo 'bhūḥ praharannapi tvam /	You should not be ashamed; for, though striking me, you were moved (for a moment) with compassion; let not the rudeness of a refusal be shown to me who am beseeching you.
tathetyupaspṛśya payaḥ pavitraṃ somodbhavāyāḥ sarito nṛsomaḥ / udaṅmukhaḥ so 'stravidastramantraṃ jagrāha tasmādvigṛhītaśāsī // Ragh(K)_5.59 //	With the words 'Be it so' the eminent (lit. the moon among men) prince, skilled in the use of weapons, having sipped the holy water of the river sprung from Soma (Narmadâ) and turned his face towards the north, received (learned) the incantations of ( connected with the missile from him who was freed from the curse.
eko yayau caitrarathapradeśānsaurājyaramyānaparo vidarbhān // Ragh(K)_5.60 //	Of them two, who, by a strange chance, had thus formed on the way, a friendship (originating) from some unknown cause, one went to the regions of Chaitraratha and the other to the country of Vidarbha delightful on account of the good govern- ment (it enjoyed ).
pratyujjagāma krathakaiśikendraścandraṃ pravṛddhormirivormimālī // Ragh(K)_5.61 //	The lord of the Krathakais'ikas filled with ecstatic joy went forth to receive him who had halted in the vicinity of theCanto V. ] ( 41 ) city, as the ocean with its swelling waves goes forth to receive the moon.
praveśya cainaṃ puramagrayāyī nīcaistathopācaradarpitaśrīḥ /	Walking in the front he led him into the city, and having presented to him his wealth, waited upon (ministered to) him with humility.
mene yathā tatra janaḥ sameto vaidarbhamāgantumajaṃ gṛheśam // Ragh(K)_5.62 //	in such a way that the people assembled there con- sidered Aja to be the host (lit. the lord of the palace) and the king of the Vidarbhas to be the guest.
ramyāṃ raghupratinidhiḥ sa navopakāryāṃ bālyātparāmiva daśāṃ madano 'dhitasthau // Ragh(K)_5.63 // tatra svayaṃvarasamāhṛtarājalokaṃ kanyālalāma kamanīyamajasya lipsoḥ / bhāvāvabodhakaluṣā dayiteva rātrau nidrā cireṇa nayanābhimukhī babhūva // Ragh(K)_5.64 //	He, the representative of Raghu, occupied the delightful new pavilion into which he was shown by the officers of king Bhoja, bending low (before him), and in which vessels filled with water were placed on a dais near its eastern entrance, as Madana (Cupid) occupies the state (age) next to childhood. There, like a loved spouse unable to read (understand) the feelings (of her husband), (or, clouded-displeased by her divination of the mental attitude-affection for a rival), Sleep came late at night towards the eyes of Aja, longing to win the captivat- ing gem of a damsel, by whom a host of kings was caused to be assembled at her self-choice-marriage.
taṃ karṇabhūṣaṇanipīḍitapīvarāṃsaṃ śayyottaracchadavimardakṛśāṅgarāgam / vaitālikā lalitabandhamanoharābhiḥ prābodhayannuṣasi vāgbhiruṣarbudhābham // Ragh(K)_5.65 //	At dawn, the sons of bards, of equal age (with Aja), and eloquent in speech, awakened, with their panegyrical songs, him, of reputed scholarship, whose stout shoulders were pressed by his ear-ornaments and the sweet unguents applied to whose body were almost effaced by his rollings on the bed-sheet.
rātrirgatā matimatāṃ vara muñca śayyāṃ dhātrā dvidhaiva jagato nanu dhūrvibhaktā /	"O you, best of talented men, the night is gone; quit your bed; surely the burden of the world has been divided into two parts only, by the Creator: your vigilant father bears it at one end and your.
yāmekatastava bibharti gururvitandrīryasyā bhavānaparadhuryapadāvalambī // Ragh(K)_5.66 //	honour is the supporter of the other (lit. that borne by the other bearer).
nidrāvaśena bhavatā hyanavekṣyamāṇā paryutsukatvamabalā niśi khaṇḍiteva / lakṣmīrvinodayati yena digantalambī so 'pi tvadānanarucaṃ vijahāti candraḥ // Ragh(K)_5.67 //	The moon by (looking at) whom the goddess of beauty (Lakshmi) was diverting herself at night, like a woman offended by her husband, (somehow) disregarding even her longing for you under the influence of sleep ;-he, too, now resting on the extremity of the western horizon, is giving up (losing) the splendour of your face. [Or, with the reading , (see notes): -The moon by (looking at ) whom the goddess of beauty, though neglected by you under the influence of sleep, was, like a woman offended by her husband, beguiling her love-longing, even he &c.] 68.
tadvalgunā yugapadunmiṣitena tāvat sadyaḥ parasparatulāmadhirohatāṃ dve /	Let, therefore, the two, by their beautiful simultaneous unfolding, obtain mutual similitude: viz.
praspandamānaparuṣetaratāramantaścakṣustava pracalitabhramaraṃ ca padmam // Ragh(K)_5.68 //	your eye with the(42) [ Canto V. lively (lit. other than rough) pupil rolling about within and the lotus with a black bee moving inside.
vṛntaślathaṃ harati puṣpamanokahānāṃ saṃsṛjyate sarasijairaruṇāṃśubhinnaiḥ / svābhāvikaṃ paraguṇena vibhātavātaḥ saugandhyamīpsuriva te mukhamārutasya // Ragh(K)_5.69 // tāmrodareṣu patitaṃ drumapallaveṣu nirdhautahāragulikāviṣadaṃ himāmbhaḥ /	The morning breeze, as if desirous of obtaining, by means of borrowed properties, the natural fragrance of the breath of your mouth, bears away the loosened flowers of trees from their stalks and comes in contact with lotuses opened by the rays of the morning sun (Aruņa). The dew-drops, white like the well-cleansed pearls of a necklace, fallen on the tender leaves of trees with their interiors red, resemble, on account of the position of advantage thus gained by them (or their increased excellence), your sportive smile fallen on your lip, brightened by the splendour of your teeth.
āyodhanāgrasaratāṃ tvayi vīra yāte kiṃ vā ripūṃstava guruḥ svayamucchinatti // Ragh(K)_5.71 //	While the sun, the store of radiant heat, does not rise, even before that, darkness has been, all at once, dispelled by Aruna; when, O hero, you have taken the lead in battles, will (why should) your sire himself extirpate the foes? 72.
śayyāṃ jahatyubhayapakṣavinītanidrāḥ senāgajā mukharaśṛṅkhalakarṣiṇaste / yeṣāṃ vibhānti taruṇāruṇarāgayogādbhinnādrigairikataṭā iva dantakośāḥ // Ragh(K)_5.72 //	Your elephants, with their sleep shaken off from both sides, are leaving their beds, pulling at their clanking chains: the elephants whose bud-like tusks seem as if they had pierced the red-mineral-skirts of a mountain, on account of their having come in contact with the rosy tints of the morning sun.
vaktroṣmaṇā malinayanti purogatāni lehyāni saindhavaśilāśakalāni vāhāḥ // Ragh(K)_5.73 // bhavati viralabhaktirmlānapuṣpopakāraḥ svakiraṇapariveśodbhedaśūnyāḥ pradīpāḥ /	O lotus-eyed one, the horses of the breed of the Vanâyu country (Persian horses), tied in spacious tents, having given up their sleep, are soiling with the warm breath (vapour) of their mouth the pieces of rock-salt placed before them for being licked. The flower-offering, being withered, has become loose in texture; the lamps are void of the throbbing circles (halo) of their light; and this your sweet-speaking parrot resting in its cage, imitates our speech employed to rouse you.
ayamapi ca giraṃ nastvatprabodhaprayuktāmanuvadati śukaste mañjuvākpañjarasthaḥ // Ragh(K)_5.74 // iti sa vihṛtanidrastalpamalpetarāṃsaḥ suragaja iva gāṅgaṃ saikataṃ supratīkaḥ /	The prince, his sleep dispelled by the young bards singing their songs in this strain, instantly left his bed, just as the heav- enly elephant, Supratîka, awakened from sleep by the royal swans cackling sweetly under excitement, leaves the sandy beach of the Ganges".
sa tatra mañceṣu vimānakalpeṣvākalpasammūrchitarūpaśobhān / siṃhāsanasthānnṛpatīnapaśyadyūpānprayastāniva haimavedīn // Ragh(K)_6.1 //	There he saw the protectors of the human world ( kings), seated on thrones placed on richly furnished platforms, and attired in fascinating dresses, (thereby) imitating the majesty of the gods moving in celestial cars.
ratergṛhītānunayena kāmaṃ pratyarpitasvāṅgamiveśvareṇa / kākutsthamālokayatāṃ nṛpāṇāṃ mano babhūvendumatīnirāśam // Ragh(K)_6.2 //	The mind of kings seeing Aja (lit. the scion of Kakutstha's race), who looked like Kâma with his corporeal frame restored to him by S'iva, at (lit. accepting) the entreaties of Rati, lost all hope of winning Indumatí.
vaidarbhanirdiṣṭamatho kumāraḥ klṝúptena sopānapathena mañcam / śilāvibhaṅgairmṛgarājaśāvastuṅgaṃ nagotsaṅgamivāruroha // Ragh(K)_6.3 //	The prince ascended the dais pointed out by the Vidarbha king, by means of a well-constructed flight of steps, as the young cub of the lord of beasts (lion) climbs the lofty peak of a mountain by means of (step-like) projecting rocks. Seated on a throne covered with tapestry of the richest colour and set with jewels, his majestic appearance was most comparable with Guha ( Kàrttikeya ) when riding his peacock.
tāsu śriyā rājaparamparāsu prabhāviśeṣodayadurnirīkṣyaḥ / sahasradhātmā vyarucadvibhaktaḥ payomucāṃ paṅktiṣu vidyuteva // Ragh(K)_6.5 //	Her own self, portioned out in a thousand ways into those rows of kings by Lakshmî, and dazzling to the eyes on account of the appearance of a peculiar effulgence, shone pre-eminently like the flash of lightning which distributes itself into so many rows of clouds.
teṣāṃ mahārhāsanasaṃśrayāṇāmudāttanepathyabhṛtāṃ sa madhye / rarāja dhāmnā raghusūnureva kalpadrumāṇāmiva pārijātaḥ // Ragh(K)_6.6 //	In the midst of those kings, all seated on magnificent thrones, and dressed in splendid costumes, the son of Raghu alone shone (looked pre-eminent) by his majestic lustre, like the tree Pârijáta in the midst of other heavenly trees.
madotkaṭe recitapuṣpavṛkṣā gandhadvipe vanya iva dvirephāḥ // Ragh(K)_6.7 //	The rows of the eyes of citizens leaving all (other) princes fell (rested) on him, just as the black bees vacating the flower- trees fall upon a wild scent-elephant, infuriated under the influence of ichor.
atha stute vandibhiranvayajñaiḥ somārkavaṃśye naradevaloke / sañcārite cāgurusārayonau dhūpe śikhāvāsitaketumāle // Ragh(K)_6.8 //	Now, while the whole assembly of monarchs, sprung from the solar and lunar races, was being glorified by bards acquainted with the pedigrees of kings, and the fume of the burnt pith of the fragrant aloe wood was ascending (curling up) to the flags on high, 9.
puropakaṇṭhopavanāśrayāṇāṃ śikhaṇḍināmuddhatanṛttahetau / pradhmātaśaṅkhe parito digantāṃstūryasvane mūrchati maṅgalārthe // Ragh(K)_6.9 //	while the sound of auspicious musical instruments swelled by the blasts of conch-shells was waxing loud and spreading all round in the quarters of heaven, making the peacocks roosting in the suburban gardens dance in a frantic manner, 10. the princess, who was about to elect her husband, and who had put on apparel suited to the nuptial rite, entered R.
manuṣyavāhyaṃ caturantayānamāsthāya kanyāparivāraśobhi /	T. 6( 44 ) [ Canto VI. the high road between the rows of platforms, seated in a quadrangular conveyance carried by men, and beautiful by her train of attendants.
nipeturantaḥkaraṇairnarendrā dehaiḥ sthitāḥ kevalamāsaneṣu // Ragh(K)_6.11 //	The kings fell down by their hearts on ( had their hearts at once drawn to) that supremely exquisite creation of the Creator, in the form of the damsel, the cynosure of hundreds of eyes; their bodies alone remained on their seats.
pravātaśobhā iva pādapānāṃ śṛṅgāraceṣṭā vividhā babhūvuḥ // Ragh(K)_6.12 //	Various were the amatory gestures, the first messengers of their love, exhibited by the kings who had betrayed their passion for her, as are the beautiful tender sprouts by trees.
kaścitkarābhyāmupagūḍhanālamālolapattrābhihatadvirepham / rajobhirantaḥpariveśaśobhi līlāravindaṃ bhramayāñcakāra // Ragh(K)_6.13 // visrastamaṃsādaparo vilāsī keyūrakoṭikṣaṇajātasaṅgam /	A certain king began to whirl round a sportive lotus, hold- ing its stock with both his hands, its restless petals striking black bees and its pollen forming a circle within it. Another gallant, with his handsome face obliquely turned round, drew up and put in its proper place the garland that had slipped from his shoulder and was sticking to the points of his armlet inlaid with gems.
ākuñcitāgrāṅgulinā tato 'nyaḥ kiñcitsamāvarjitanetraśobhaḥ / ratnāṃśusampṛktanakhaprabheṇa pādena haimaṃ vililekha pīṭham // Ragh(K)_6.15 //	A third again, with beautiful eyes slightly turned down- wards, drew lines on the gold foot-stool with his foot, the top-toes of which were a little contracted and the lustre of whose nails was spread obliquely.
vilāsinīvibhramadantapatramāpāṇḍuraṃ ketakabarhamanyaḥ / priyānitambocitasannipātairvipāṭayāmāsa yuvā nakhāgraiḥ // Ragh(K)_6.17 // kuśeśayātāmratalena kaścitkareṇa rekhādhvajalāñchanena /	One king, resting his left arm on a part of his seat, his shoulder being raised a little by that act, became intent upon talking to a friend, his pearl-necklace rolling over (or lying divided on) the lower part of his spine as it was slightly turned. Another young prince tore off, with the points of his nails, fit to be set on the hips of his beloved, a kelaka leaf, of a yellowish white colour, which serves as a sportive ear-ornament to coquet- tish women.
kaścidyathābhāgamavasthite 'pi svasanniveśavyatilaṅghinīva / vajrāṃśugarbhāṅgulirandhramekaṃ vyāpārayāmāsa karaṃ kirīṭe // Ragh(K)_6.19 //	Some one sportively cast up the dice, illumined with the glow of his jewelled ring, with his hand, the palm of which was as red as a lotus, and bore linear marks of banners. Some one put one of his hands, the lustre of the diamonds shooting through the finger chinks, on his crown, as if the latter had slipped from its proper place, although it was in its right position.
tato nṛpāṇāṃ śrutavṛttavaṃśā puṃvatpragalbhā pratihārarakṣī /	Then Sunandâ, the door-keeper of the harem, bold (clever in speech like a man, and well acquainted with the lives and pedi-Canto VI.
prāksannikarṣaṃ magadheśvarasya nītvā kumārīmavadatsunandā // Ragh(K)_6.20 //	] ( 45 ) grees of kings, took the princess, first of all, to the presence of the king of the Magadhas, and thus spoke- 21.
rājā prajārañjanalabdhavarṇaḥ parantapo nāma yathārthanāmā // Ragh(K)_6.21 // kāmaṃ nṛpāḥ santi sahasrasaṅkhyā rājanvatīmāhuranena pṛthvīm /	This is the king who rules over the Magadha land-the refuge of those who look up to him for protection, of spirit unfathomable, and renowned for governing his people well- Paramtapa by name, true to the sense. Granted that there are other kings by thousands; but the earth is said to have a pious ruler in him alone.
nakṣatratārāgrahasaṅkulāpi jyotiṣmatī candramasaiva rātriḥ // Ragh(K)_6.22 //	True that the night is crowded with constellations, stars and planets; but it is by reason of the moon alone that it has light (is illumined ).
kriyāprabandhādayamadhvarāṇāmajasramāhūtasahasranetraḥ / śacyāściraṃ pāṇḍukapolalambānmandāraśūnyānalakāṃścakāra // Ragh(K)_6.23 //	This king having to invite Indra (lit. the god with a thousand eyes) incessantly (to the earth), on account of the un- interrupted course of his sacrificial rites, caused (thereby) the tresses of s'achi to be long flowing about her pallid cheeks and undecked with the flowers of the Mandára tree.
anena cedicchasi gṛhyamāṇaṃ pāṇiṃ vareṇyena kuru praveśe / prāsādavātāyanasaṃśrayāṇāṃ netrotsavaṃ puṣpapurāṅganānām // Ragh(K)_6.24 //	If you wish that your hand should be accepted in marriage by this (prince), worthy to be chosen, then by accepting him) give delight to the eyes of the ladies of Pushpapura, as they will be looking at you, at the time of your entering the city, from the windows of the mansions.
evaṃ tayokte tamavekṣya kiñcidvisraṃsidūrvāṅkamadhūkamālā /	When she had said this, the thin princess looked at him, and without saying anything rejected him, with a cold salutation. while her garland of Madhûka flowers interspersed with dûrv û grass was slightly displaced.
ṛjupraṇāmakriyayaiva tanvī pratyādideśainamabhāṣamāṇā // Ragh(K)_6.25 // tāṃ sātha vetragrahaṇe niyuktā rājāntaraṃ rājasutāṃ nināya / samīraṇottheva taraṅgalekhā padmāntaraṃ mānasarājahaṃsīm // Ragh(K)_6.26 //	The very same maid, whose office it was to bear the cane staff, conducted the princess to a second king, just as a wave raised by the wind carries a female swan of the ma'nasa lake from one lotus to another; 27. and spoke to her-this is the lord of the Angas, whose youthful beauty had been coveted by (enamoured) the damsels of heaven, and who, having his elephants trained by the founders of the elephantine science, enjoys Indra's position though on earth. He, causing drops of tears as big as pearls to roll about on the bosoms of the wives of his enemies.
jagāda caināmayamaṅganāthaḥ surāṅganāprārthitayauvanaśrīḥ / vinītabhāgaḥ kila sūtrakārairaindraṃ padaṃ bhūmigato 'pi bhuṅkte // Ragh(K)_6.27 //	In his prison-house dwelt the lord of Lanká, the conqueror even of Indra, whose arms were rendered motionless by being bound with the bow-string, and whose row of mouths was gast- ing for breath, until the captor's pleasure (set him free). In his line is born this prince, Pratipa by name, who reverentially honours those versed in sacred lore, and by whom has been wiped off the reproach that S'ri is fickle by nature, a reproach which attaches to her name owing to the faults of those with whom she resides.
anena paryāsayatāśrubindūnmuktāphalasthūlatamānstaneṣu /	Do this youthful prince the honour of accepting him as your husband, O fair princess, and enjoy (the wealth, i.e., pleasures of) your youthful age, on a flower-bed, having tender leaves for its counterpane, in Vrindávana, not inferior to Chaitraratha (the garden of Kubera).
pratyarpitāḥ śatruvilāsinīnāmākṣepasūtreṇa vinaiva hārāḥ // Ragh(K)_6.28 //	He, with beautiful arms, and the foremost of archers, bears on his forearms two scars made by the bow-string, as if they are the two pathways, besprinkled with tears mixed with colly- rium of the Fortunes of his foes made captives by him.Canto VI.
nisargabhinnāspadamekasaṃstham asmindvayaṃ śrīśca sarasvatī ca /	His fame has gone up to the mountains, descended to the seas, entered the nether world, the dwelling-place of the serpents, and has found its way to heaven; thus spreading without cessation it is quite incapable of being exactly gauged.
kāntyā girā sūnṛtayā ca yogyā tvameva kalyāṇi tayostṛtīyā // Ragh(K)_6.29 //	Do you choose him who is your equal in birth, beauty and youth, and in those various virtues of which modesty is the chief; let the jewel be matched with gold.
athāṅgarājādavatārya cakṣuryāteti janyānavadatkumārī / nāsau na kāmyo na ca veda samyag draṣṭuṃ na sā bhinnarucirhi lokaḥ // Ragh(K)_6.30 //	Then at the conclusion of Sunandà's speech, the princess, lessening her bashfulness, accepted the prince, by casting at him a bright glance of joy, as if with the marriage-garland. Through her maidenly bashfulness the princess could not give expression to the love she felt for the young prince; but the love of that curly-haired damsel, piercing through her slender frame, manifested itself in the guise of her hair standing on end.
tataḥ paraṃ duṣprasahaṃ pareṣāṃ nṛpaṃ niyuktā pratihārabhūmau /	another;" thereupon the bride looked at her with a frown of dis- pleasure.
nidarśayāmāsa viśeṣakāntaminduṃ navotthānamivendumatyāḥ // Ragh(K)_6.31 //	Then the fair women of the city, setting aside all othe occupations in their eagerness to have a look at the bridegroom' acted in the following manner, in mansions having lattice-window of gold.
avantinātho 'yamudagrabāhurviśālavakṣāstanuvṛttamadhyaḥ /	He, dressed in silken garments, was led near the bride by the well-behaved keepers of the harem, as the (water of the) sea with its clear lines of foam is carried on to the shore by the new rays of the moon.
āropya cakrabhramamuṣṇatejāstvaṣṭreva yantrollikhito vibhāti // Ragh(K)_6.32 //	The lord of Kundina, having passed three nights on the way with Aja, renowned in the three worlds, turned back from him, as the moon recedes from the sun at the end of the conjunc- tion.
asya prayāṇeṣu samagraśakteragresarairvājibhiruddhatāni /	The two arrays of forces obtained from each other fluctu- ating defeat and victory; just like two waves of the mighty main, swelling up as a backward and forward gale blows alternately.
kurvanti sāmantaśikhāmaṇīṇāṃ prabhāprarohāstamayaṃ rajāṃsi // Ragh(K)_6.33 // asau mahākālaniketanasya candrārdhamaulernivasannadūre / divāpi jālāntaracandrikāṇāṃ nārīsakhaḥ sparśasukhāni bhuṅkte // Ragh(K)_6.34 //	That peerless warrior, seated in a chariot, with a quiver behind, clad in mail, holding a bow in his hand, and high-spirit- ed, repelled the foe; just as the great boar (Vishnu's incarnation) drove back the oceanic waters overflowing their bounds at the final destruction of the universe. When engaged in battle he was seen putting the right nor the left hand into (or, after Malli,-beautifully moving his right hand about) the mouth of the quiver; it seemed as if the bow. string of the warrior, once drawn to his ear, produced arrows that could kill his foes.
anena yūnā saha pārthivena rambhoru kaccinmanaso ruciste /	Now in the fight, all the kings with all efforts (or all.
siprātaraṅgānilakampitāsu vihartumudyānaparamparāsu // Ragh(K)_6.35 //	their might) attacked him with all the constituent parts of their armies, the war elephants being the chief among them, and us- ing all weapons, powerful enough to pierce through the coat of mail.
tasminnapi dyotanarūpabimbe pratāpasaṃśoṣitaśatrupaṅke /	His chariot being covered with volleys of missiles, he could be distinguished only by the top of his flagstaff, just as the forepart of the day, obscured by the mist, is known only by the faintly shining sun.
tāmagratastāmarasāntarābhām anūparājasya guṇairanūnām /	Then the army of the lords of men stood (including them - selves) overpowered by sleep, their hands not able to draw the bow, their helmets slipping disorderly on one shoulder and their bodies reclining against the flagstaffs.
vidhāya sṛṣṭiṃ lalitāṃ vidhātur jagāda bhūyaḥ sunasāṃ sunandā // Ragh(K)_6.37 //	fame, as it were, earned by the might of his arms. His own warriors, who now returned on recognising the sound of the conch (blown by Aja), saw him in the midst of his slumbering foes, like the shining image of the moon in the midst of closed lotuses.
saṅgrāmanirvṛttasahasrabāhuraṣṭādaśadvīpanikhātayūpaḥ / ananyasādhāraṇarājaśabdo babhūva yogī kila kārtavīryaḥ // Ragh(K)_6.38 //	He caused to be impressed on the banners of the kings, by means of the points of the arrows dipped in blood, the following words: 'Your glory has now been taken away by the son of Raghu, but not your lives, through mercy.' 66. He, with one arm placed on the extremity of his bow, the tie of his hair loosened by the removal of the helmet, and his brow covered with perspiration brought on by fatigue, came to his terrified spouse and spoke to-her- 67.
akāryacintāsamakālameva prādurbhavaṃścāpadharaḥ purastāt /	T. Her face, at once freed from the sadness arising from the enemy, glowed with joy, like a mirror with its natural brightness restored to it by the disappearance of the moisture caused by breath.
antaḥśarīreṣvapi yaḥ prajānāṃ pratyādideśāvinayaṃ vinetā // Ragh(K)_6.39 //	Verily other princes strive to gain possession of a kingdom even by foul means; but the same, Aja accepted, when it came to him, simply in obedience to his father's command, and not ont of thirst for enjoyment.
jyābandhaniḥspandabhujena yasya viniḥśvasadvaktraparampareṇa / kārāgṛhe nirjitavāsavena daśānanenoṣitamā prasādāt // Ragh(K)_6.40 //	Having undergone the ceremony of sprinking along with him (2. e. the prince Aja, at the time of his coronation) with the water consecrated by Vasishfha, the Earth expressed as it were the gratification (of her wishes) by her clear (white) exhalations. The subjects looked upon their new sovereign as Raghu himself restored to youth; for he not only inherited his regal for- tune but also all his virtues.
tasyānvaye bhūpatireṣa jātaḥ pradīpa ityāgamavṛddhasevī /	The Earth and Indumatî having obtained for their husband him whose manly powers were of the highest kind, the first produced various jewels while the second gave birth to a warlike son.
yena śriyaḥ saṃśrayadoṣarūḍhaṃ svabhāvaloletyayaśaḥ pramṛṣṭam // Ragh(K)_6.41 //	His power was for allaying the fears of the distressed and his great learning for showing reverence to the learned; thus, not only the wealth of that king but even his possession of good qualities was (meant) for the benefit (good) of others.
āyodhane kṛṣṇagatiṃ sahāyamavāpya yaḥ kṣatriyakālarātrim /	The lord of the Kosalas, bemoaning (the loss of) his wife in this pathetic strain, made even the trees pour down a heavy shower of tears in the form of the exudations of the branches.
dhārāṃ śitāṃ rāmaparaśvadhasya sambhāvayatyutpalapattrasārām // Ragh(K)_6.42 //	Afterwards, the rites which were to be performed after the expiry of ten days, in connexion with his wife, whose virtues only remained, were finished in great affluence (magnificence ) by that wise king in the very garden of the city.
asyāṅkalakṣmīrbhava dīrghabāhormāhiṣmatīvapranitambakāñcīm /	The sage sees by his unobstructed eye of knowledge the triad the past, the present and the future-in the three worlds (lit. steps of the God who is without birth).
prāsādajālairjalaveṇiramyāṃ revāṃ yadi prekṣitumasti kāmaḥ // Ragh(K)_6.43 // tasyāḥ prakāmapriyadarśano 'pi na sa kṣitīśo rucaye babhūva /	This earth should be protected by you : for the Earth is the real wife of kings. Avoiding the censure of being called arrogant when good fortune smiled upon you, you showed by your self-possession (the good effects of) your knowledge: now that mental pain has be-fallen you, you should boldly show it again. How can she be obtained by you (by) crying? She can- not be obtained by you even by dying after her.
śaratpramṛṣṭāmbudharoparāgaḥ śaśīva paryāptakalo nalinyāḥ // Ragh(K)_6.44 //	The paths of persons going to the other world are different (lit. With your mind relieved of its anguish, (you should) favour your wife by offering libations of water, &c.
sā śūrasenādhipatiṃ suṣeṇamuddiśya deśāntaragītakīrtim / ācāraśuddhobhayavaṃśadīpaṃ śuddhāntarakṣyā jagade kumārī // Ragh(K)_6.45 //	Accepting the message of the noble-minded preceptor with the words "Be it so" he dismissed the sage (bade him farewell); but the message, not having found a place in his heart full of grief, returned, as it were, to the preceptor. Considering the childhood (tender age) of his son, that king, of agreeable but true speech, somehow (with great difficulty ) passed eight years by means of (the consolation derived from) look- ing at the pictures of his beloved and at objects having a like- ness to her, and also by means of the pleasure derived from her momentary company in dreams.
nīpānvayaḥ pārthiva eṣa yajvā guṇairyamāśritya paraspareṇa / naisargiko 'pyutsasṛje virodhaḥ siddhāśramaṃ śāntamivaitya sattvaiḥ // Ragh(K)_6.46 //	However, on account of his impatience to follow his beloved, he looked upon it as a gain, although it was the cause of the destruction of his life and was incurabie by physicians. Afterwards, having entrusted, according to the rules, his son who was properly educated and who was old enough to wear armour, with the protection of the subjects (i.e., with the duty of protecting the subjects ), the king, wishing to leave the wretched(70) [ Canto IX.
yasyātmadehe nayanābhirāmā kāntirhimāṃśoriva sanniviṣṭā / harmyāgrasaṃrūḍhatṛṇāṅkureṣu tejo 'viṣahyaṃ ripumandireṣu // Ragh(K)_6.47 //	became intent on residence in the body affected by diseases, starving himself to death. Having secured a place (lit. reckoning) amongst the im- mortals, immediately after abandoning his body at the confluence of the Ganges and the Sarayû, and being reunited with his wife (now) possessing a loveliness surpassing that of her former form, he sported again in the pleasure-houses in the Nandana garden.
yasyāvarodhastanacandanānāṃ prakṣālanādvārivihārakāle /	Wise men speak of only two (persons) as the removers of the fatigue of those who have done their duty by timely gifts (of rain and wealth respectively), viz.
kalindakanyā mathurāgatāpi gaṅgormisampṛktajaleva bhāti // Ragh(K)_6.48 //	Just as the Earth maintained prosperity (or splendour) by means of (the prowess of) Raghu who had conquered the ten quar- ters and after him by means of Aja, so also did she shine again, having obtained for her lord him whose valour (prowess) was nothing short (of theirs).
vakṣaḥsthalavyāpirucaṃ dadhānaḥ sakaustubhaṃ hrepayatīva kṛṣṇam // Ragh(K)_6.49 // sambhāvya bhartāramamuṃ yuvānaṃ mṛdupravālottarapuṣpaśayye / vṛndāvane caitrarathādanūne nirviśyatāṃ sundari yauvanaśrīḥ // Ragh(K)_6.50 //	By his impartiality, by sending down the shower of riches (i.e. gifts of wealth) and by punishing (restraining) the wicked, he equalled respectively Yama (the God of Death), Kubera (lit. lord of the Yakshas) and Varupa; and by his splendour (lustre) he resembled the Sun.Canto IX. Neither love for hunting, nor gambling, nor wine having the reflection of the moon for its ornament, nor a beloved (mistress) of fresh youth ( i.e. in the prime of youth), diverted (the mind of) him who was striving for rise ( prosperity). He did not address a supplicating speech even to Indra although he (Indra) was his (Das'aratha's) lord, nor did he tell a lie even in jest.
adhyāsya cāmbhaḥpṛṣatokṣitāni śaileyanaddhāni śilātalāni / kalāpināṃ prāvṛṣi paśya nṛttaṃ kāntāsu govardhanakandarāsu // Ragh(K)_6.51 //	Being free from (the influence of) anger he did not use (lit. speak) abusive (or harsh) language even towards his enemies. The (subordinate) kings obtained both rise and fall from (i.e. at the hands of) the descendant of Raghu. He was friendlly towards those who did not transgress his commands but had a stern heart towards those who defied him.
nṛpaṃ tamāvartamanojñanābhiḥ sā vyatyagādanyavadhūrbhavitrī / mahīdharaṃ mārgavaśādupetaṃ srotovahā sāgaragāminīva // Ragh(K)_6.52 // athāṅgadaśliṣṭabhujaṃ bhujiṣyā hemāṅgadaṃ nāma kaliṅganātham /	He, whose bow was strung, conquered the Earth girt by the ocean (lit. whose circumference is the ocean) by means of one chariot only (i.e. without the aid of any body else). While his army abounding in elephants and steeds, impetuous through speed, simply proclaimed his victory. Verily the oceans, thundering like the clouds, served as drums proclaiming the victory of him, who, being an eminent bowman, conquered the Earth by means of a matchless (or single) chariot furnished with a protecting apparatus, and whose wealth equalled that of Kubera.
āseduṣī sāditaśatrupakṣaṃ bālāmabālendumukhīṃ babhāṣe // Ragh(K)_6.53 //	Indra destroyed the force of the wings of mountains by means of (his ) hundred-edged adamant; while he (Das'aratha), whose face resembled a fresh lotus, routed the army and the allies of his enemies by his twanging bow, that poured forth a shower of arrows.
asau mahendrādrisamānasāraḥ patirmahendrasya mahodadheśca /	Hundreds of kings touched the feet of him (lit. touched him at his feet) whose prowess knew no repulse, with the rays of the jewels in their crowns having their splendour enhanced by the redness (lustre) of the nails, just as the gods bow down to Indra.
yasya kṣaratsainyagajacchalena yātrāsu yātīva puro mahendraḥ // Ragh(K)_6.54 //	( 72 ) the Moon, and besides whose white umbrella none other was raised (on the Earth), became vigilant, although he had attained the position of a paramount sovereign of the circle (of twelve princes).
jyāghātalekhe subhujo bhujābhyāṃ bibharti yaścāpabhṛtāṃ purogaḥ / ripuśriyaḥ sāñjanavāṣpaseke vandīkṛtāyā iva paddhatī dve // Ragh(K)_6.55 // yamātmanaḥ sadmani saudhajālairālokyavelātaṭapūgamālaḥ /	Laying aside his crown during the (performance of) sacri- fices, he, who had collected the wealth of all the quarters and who was free from the quality of darkness (ignorance), made the banks of the Tamasâ and the Sarayú look beautiful by erecting sacrificial posts of gold. The Lord, abiding in the body (of Das'aratha), which was - consecrated for the sacrifice, which held the skin of an antelope and a staff, which wore a girdle of Kus'a grass, which had its speech restrained and which was furnished with the horn of a deer, made it shine with unsurpassed brightness.
mandradhvanityājitayāmatūryaḥ prabodhayatyarṇava eva suptam // Ragh(K)_6.56 //	He who was purified by the ablutions performed at the . end of the sacrifices, who had curbed his senses and who wasCanto IX.
anena sārdhaṃ viharāmburāśestīreṣu tālīvanamarmareṣu / apākṛtasvedalavā marudbhirdvīpāntarānītalavaṅgapuṣpaiḥ // Ragh(K)_6.57 //	First there was the bursting forth of flowers; then there were fresh sprouts, and after that the humming of bees and the cooing of cuckoos: -thus did Spring descending (incarnate) to the forest-site abounding in trees manifest himself in the proper order. The bees and the water-fowls (or, swans) repaired to the lotus-plant in the lake replenished (z.
prabodhitāpyākṛtilobhanīyā vidarbharājāvarajā tayaivam /	e. endowed with the wealth of flowers) by the spring, just as supplicants resort to the wealth of the king amassed by the excellence of his state policy (or by his statesmanship and other qualities) and whose purpose is to benefit the good.
tasmādapāvartata pauruṣeṇa nīteva lakṣmīḥ pratikūladaivāt // Ragh(K)_6.58 //	The sun could not, indeed, at that stage, completely dis- sipate the frost, which was unbearable to the lower lips of young( 74 ) [ Canto. IX..
athonnasaṃ nāgapurasya nāthaṃ dauvārikī devasarūpametya /	even of those who had subdued hatred and passion.
itaścakorākṣi vilokayeti nāgāṅganābhāṃ nijagāda bhojyām // Ragh(K)_6.59 //	·Canto IX. j (75) 41. Verily the Tilaka plant, which was variegated with bees, charming like marks of collyrium, alighting on rows (or collections) of flowers, did but grace (adorn) the forest site just as the 'tilaka' mark decorates a young woman.
pāṇḍyo 'yamaṃsārpitalambahāraḥ klṝúptāṅgarāgo haricandanena /	The Jasmine creeper, the charming beloved of the trees, fascinated the mind (of the lookers-on) by the beauty of the smiles, brought about by flowers, possessing the smell of honey (wine) and spreading over the lower lip in the form of the sprouts.
ābhāti bālātaparaktasānuḥ sanirjharodgāra ivādrirājaḥ // Ragh(K)_6.60 //	It (t. e. chase) makes one intimate (lit. produces familia- rity ) with (the art of) shooting down a moving mark (game); it gives the knowledge of their gestures in (moinent) of fear and rage; R. T.
vindhyasya saṃstambhayitā mahādrerniḥśeṣapītojjhitasindhunāthaḥ / prītyāśvamedhāvabhṛthārdramūrteḥ sausnātiko yasya bhavatyagastyaḥ // Ragh(K)_6.61 //	and it makes the body acquire excellent qualities owing to the conquest over fatigue; being, for these reasons, permitted by his ministers, he went out ( for hunting). That mighty monarch, putting on a dress suitable (fitted) for going to the forest abounding in game and having the bow resting on his broad neck, furnished the sky with a canopy as it were by means of the dust raised by the hoofs of horses (or made it a mere void, i.e. non-existent).
astraṃ harādāptavatā durāpaṃ yenendralokāvajayāya dṛptaḥ /	The sylvan deities, with their bodies incorporated into slender creepers, and with the function of their eyes transferred to the bees, saw him on the way who had beautiful eyes and who pleased (made happy) the people of Kosala by his righteous con- duct (or just rule).
purā janasthānavimardaśaṅkī sandhāya laṅkādhipatiḥ pratasthe // Ragh(K)_6.62 // anena pāṇau vidhivadgṛhīte mahākulīnena mahīva gurvī /	He then entered the forest which was first occupied by the keepers of hounds and deer-catchers ( lit. persons who carried about with them nets for catching deer) which was cleared of fire and thieves, the ground in which was firm and (hence) suitable for the trottings of) horses, which had reservoirs of water and which abounded in deer, birds and the Gayals.
ratnānuviddhārṇavamekhalāyā diśaḥ sapatnī bhava dakṣiṇasyāḥ // Ragh(K)_6.63 // tāmbūlavallīpariṇaddhapūgāsvailālatāliṅgitacandanāsu / tamālapattrāstaraṇāsu rantuṃ prasīda śaśvanmalayasthalīṣu // Ragh(K)_6.64 //	the rainbow) furnished with the string (in the form) of lightning as yellow as gold. In front of him appeared a herd of deer led by a proud spotted antelope, the motion of the hinds in which was oftet? obstructed by the fawns eager to suck their teats and whose mouths were full of (lit. filled with) Kusa grass. That (herd), pursued by the king riding a fleet horse, blackened the forest with their distracted glances wet with tears as if with the clusters of the juicy (fresh) petals of (blue) lotuses scattered about by the wind.
indīvaraśyāmatanurnṛpo 'yaṃ tvaṃ rocanāgauraśarīrayaṣṭiḥ / anyonyaśobhāparivṛddhaye vāṃ yogastaḍittoyadayorivāstu // Ragh(K)_6.65 // svasurvidarbhādhipatestadīyo lebhe 'ntaraṃ cetasi nopadeśaḥ /	That (eminent) archer, equal in prowess to Indra ( or, the god Vishnu) seeing the mate of the deer aimed at (by himself) stand interposing her body, and being softened with pity throughCanto IX. ] ( 77 ) his being himself a lover, withdrew his arrow though drawn to the ear. The fist of that king, intent on levelling his darts against other deer also, though firmly clenched, became loose (loosened ) after having come to the ear, as they (ż.
divākarādarśanabaddhakośe tārāpateraṃśurivāravinde // Ragh(K)_6.66 //	e. the deer) reminded him of the sportive movements of the eyes of his youthful beloveds by means of their eyes excessively tremulous through fear.
sañcāriṇī dīpaśikheva rātrau yaṃ yaṃ vyatīyāya patiṃvarā sā /	He whose duty it was to humble the proud, did not bear only the lofty horn (i.e. exalted supremacy) of others; but it is not that he did not bear also their long life.
narendramārgāṭṭa iva prapede vivarṇabhāvaṃ sa sa bhūmipālaḥ // Ragh(K)_6.67 //	fierce like the thunder clap (or the howl of contending winds in the sky); and in this he was surely actuated by jealousy of their title of 'king of the beasts, noble (conspicuous) by their valour.' .65.
vāmetaraḥ saṃśayamasya bāhuḥ keyūrabandhocchvasitairnunoda // Ragh(K)_6.68 //	In some places urging his horse in pursuit of the 'Chamara' deer and sending forth a shower of crescent-shaped arrows (1) drawn to the ear, he felt immediately at ease after having deprived them, like kings, of their white chowries (z.
na hi praphultaṃ sahakārametya vṛkṣāntaraṃ kāṅkṣati ṣaṭpadālī // Ragh(K)_6.69 // tasminsamāveśitacittavṛttiminduprabhāmindumatīmavetya /	e. their bushy tails). He did not aim his arrow at (lit. make him the mark of his arrow) the peacock having a beautiful plumage although skipping about near his horse, being instantly put in mind of the luxuriant tresses of his beloved interwoven with variegated flowers and with their band loosened in amatory sports.
pracakrame vaktumanukramajñā suvistaraṃ vākyamidaṃ sunandā // Ragh(K)_6.70 //	The sylvan breeze, which was saturated with cold dew- drops and which had opened the folds of the tender leaves, drank (dried) up the sweat caused by his hard exercise and collected into clusters of drops on his face, 69.
ikṣvākuvaṃśyaḥ kakudaṃ nṛpāṇāṃ kakutstha ityāhitalakṣaṇo 'bhūt /	The king, unattended by any followers, passed, in some place, one night, in which tender flowers and leaves served as his bedding, and which was furnished with lights (in the form) of blazing powerful herbs.
kākutsthaśabdaṃ yata unnatecchāḥ ślāghyaṃ dadhatyuttarakosalendrāḥ // Ragh(K)_6.71 //	There the king, whose slumber was dispelled at day-break by the musical flappings of the ears of the elephand-herd, resembling the sound of deep-sounding drums, amused himself by listening to the sweet auspicious songs of bards in the form of the warblings of birds.
mahendramāsthāya mahokṣarūpaṃ yaḥ saṃyati prāptapinākilīlaḥ /	Then on one occasion the king, who had taken (i.e. was following) the path of a deer, unnoticed in the forest by his attend- ants, came with his horse foaming through exhaustion to the river Tamasâ much frequented by ascetics.
cakāra bāṇairasurāṅganānāṃ gaṇḍasthalīḥ proṣitapattralekhāḥ // Ragh(K)_6.72 //	From its waters arose (or was heard) a clear, loud sound produced by the filling up of a jar; mistaking it for the grunt of an elephant, he discharged in that direction an arrow tracking (its mark) by the sound.
airāvaṇāsphālanaviślathaṃ yaḥ saṅghaṭṭayannaṅgadamaṅgadena /	] (79) with the rules (of conduct, when) blinded by passion, set foot on (i.e. follow) a wrong road.
upeyuṣaḥ svāmapi mūrtimagryāmardhāsanaṃ gotrabhido 'dhitasthau // Ragh(K)_6.73 // jātaḥ kule tasya kilendukīrteḥ kulapradīpo nṛpatirdilīpaḥ /	Being questioned about his family by him (the king) of a renowned lineage, who had got down from his horse, he (the son of the sage), with his body resting on (his) water-jar, declared himself, in faltering syllables to be the son of an ascetic of a class other than that of the twice-born. Requested by him, the king took him, even with the arrow unextracted, to his parents who had lost their sight, and approach.
atiṣṭhadekonaśatakratutve śakrābhyasūyāvinivṛttaye yaḥ // Ragh(K)_6.74 //	Verily, the fire which is lighted from (or, blazing with) fuel, though burning the soil requiring tillage, makes it productive of sprouts from seeds (z. e. yield a rich harvest).
yasminmahīṃ śāsati māninīnāṃ nidrāṃ vihārārdhapathe gatānām / vāto 'pi nāsraṃsayadaṃśukāni ko lambayedābharaṇāya hastam // Ragh(K)_6.75 //	When things have taken such a turn what shall this cruel mar, who deserves death at your hands, do ( for you )?"-thus addressed by the lord of the earth, the ascetic, who, with his wife, wished to follow his deceased son, begged for burning fuel (a funeral pyre to be lighted by him).
putro raghustasya padaṃ praśāsti mahākratorviśvajitaḥ prayoktā /	And yet he did not obtain that light called 'a Son' which instantaneously dispels the gloom of sorrow and is the means of obtaining freedom from the debt due to ancestors.
caturdigāvarjanasambhṛtāṃ yo mṛtpātraśeṣāmakarodvibhūtim // Ragh(K)_6.76 //	For a long time did the king, whose progeny was awaiting (the appearance of) an efficient cause, remain like the ocean with its production of the jewels not manifested before the churning (i.e. before its being churned).
ārūḍhamadrīnudadhīnpratīrṇaṃ bhujaṅgamānāṃ vasatiṃ praviṣṭam /	The gods beheld him, reclined on the seat of the body of the serpent, with His person illuminated by the ascending rays of the jewels in the circle of the hoods of that serpent- 8.
ūrdhvaṃ gataṃ yasya na cānubandhi yaśaḥ paricchettumiyattayālam // Ragh(K)_6.77 //	Him, who had placed His feet on the lap of Lakshmf, seated on a lotus, from which the girdle was separated by the (interven- ing) silken garment and on which were spread her tender palms- 9.
gurvīṃ dhuraṃ yo bhuvanasya pitryāṃ dhuryeṇa damyaḥ sadṛśīṃ bibharti // Ragh(K)_6.78 //	Him, whose eyes were like full-blown lotuses, whose gar- ment resembled the morning sunshine, who was easily seen (lit. whose sight was easily obtainable) by ascetics and who was (therefore) like the autumnal day, which has blooming lotuses for the eyes and morning sunshine for the garment and which is delightful to look at in the beginning (i.e.
kulena kāntyā vayasā navena guṇaiśca taistairvinayapradhānaiḥ /	at its commence- ment)- 10. Him, who wore on his broad breast the essence of the (oceanic) waters called 'Kaustubha', which served as a toilet-mirror to Lakshmf and which covered with its lustre the mark S'rívatsa- 11.
tvamātmanastulyamimaṃ vṛṇīṣva ratnaṃ samāgacchatu kāñcanena // Ragh(K)_6.79 //	Him, who on account of his branch-like arms decorated with heavenly ornaments, appeared like another Pârijáta mani festing itself in the midst of waters-Canto X.
tataḥ sunandāvacanāvasāne lajjāṃ mṛdūkṛtya narendrakanyā /	Then the gods, having made their obeisance to that de- stroyer of the demons, hymned with praises Him who is worthy of praise and who stands beyond the reach of speech and mind.
dṛṣṭyā prasādāmalayā kumāraṃ pratyagrahītsaṃvaraṇasrajeva // Ragh(K)_6.80 //	"A bow to Thee whose self exists (appears) in three forms-first as the 'Creator,' next as the 'Protector, 'and afterwards as the 'Destroyer' of the universe.
sā yūni tasminnabhilāṣabandhaṃ śaśāka śālīnatayā na vaktum /	They (the sages) know Thee to be present in the heart and yet not to be near (i, e.
romāñcalakṣyeṇa sa gātrayaṣṭiṃ bhittvā nirākrāmadarālakeśyāḥ // Ragh(K)_6.81 // tathāgatāyāṃ parihāsapūrvaṃ sakhyāṃ sakhī vetradharā babhāṣe /	They (i.e. the sages) speak of Thee as glorified by (means of) seven (metrical) hymns, as lying on the waters of the seven oceans, as having the seven-flamed fire for Thy mouth, and as being the sole support of the seven worlds. Knowledge resulting in (the attainment of the four ends of human life, the periods or Time, viz.
ārye vrajāmo 'nyata ityathaināṃ vadhūrasūyākuṭilaṃ dadarśa // Ragh(K)_6.82 //	Thy glory (or greatnass), viz., Earth and the other things, though visible, is not definable; what need we then say of Thee who are knowable (only) through authoritative testimony (the Vedas) and (processes of) inference? 29.
sā cūrṇagauraṃ raghunandanasya dhātrīkarābhyāṃ karabhopamorūḥ /	Issued forth from the mouth of the Almighty, and pos- sessed of the lustre of His teeth, it appeared like the residue of Gangá, after she had flown out from his foot, flowing upwards.
āsañjayāmāsa yathāpradeśaṃ kaṇṭhe guṇaṃ mūrtamivānurāgam // Ragh(K)_6.83 //	"I know that your greatness and prowess are superseded by the demon (Râvaņa), just as the first and, the middle qualities of embodied beings are overpowered by (the quality of) darkness.
tayā srajā maṅgalapuṣpamayyā viśālavakṣaḥsthalalambayā saḥ /	with their portions, as trees follow the wind with (their) flowers. Then, at the conclusion of the sacrifice performed with an object in view (viz.
amaṃsta kaṇṭhārpitabāhupāśāṃ vidarbharājāvarajāṃ vareṇyaḥ // Ragh(K)_6.84 // śaśinamupagateyaṃ kaumudī meghamuktaṃ jalanidhimanurūpaṃ jahnukanyāvatīrṇā /	the attainment of a son) by the king, a Being arose out of the fire along with (to) the astonishment of the officiating priests. He held in his hands rice boiled with milk placed in 2 vessel of gold, which was difficult to be borne even by him on account of the entrace of the Primeval Being (Vishnu) into it. The king accepted the food which was offered by that Being of (connected with) Prajâpati, just as Indra did the essence of the waters (Amrita), laid bare (manifested) by the ocean.
iti samaguṇayogaprītayastatra paurāḥ śravaṇakaṭu nṛpāṇāmekavākyaṃ vivavruḥ // Ragh(K)_6.85 //	That the merits of that king were such as were unattain- able by others was declared by the fact that even He, the source of the three worlds, desired to be his progeny.
pramuditavarapakṣamekatastatkṣitipatimaṇḍalamanyato vitānam / uṣasi sara iva praphultapadmaṃ kumudavanapratipannanidramāsīt // Ragh(K)_6.86 //	A fœtus, grown out of Supreme Being, was borne by them for the prosperity of the people, as is a watery embryo by solar rays, called Amritás. They (the queens), who became big with child at one and the same time and whose complexion had grown a little pale, appeared like the luxuriant crops with the appearance of the fruits hidden within.
// iti raghuvaṃśe mahākāvye ṣaṣṭhaḥ sargaḥ //	That they were worshipped by the seven Bráhmanical sages, who had performed their ablutions in the (waters of the) heavenly Ganges and who were reciting in soft tones hymas of the Supreme Spirit.
