vedo dharmamūlam /	The source of Law is the Veda, as well as the tradition (A .. n.) and practice of those who know the Veda.
dṛṣṭo dharmavyatikramaḥ sāhasaṃ ca mahatāṃ /	Transgression of the Law and violence are seen in great men.
avaradaurbalyāt /	They do not constitute precedents, however, on account of the weakness of the men of later times (cf. A ..-).
upanayanaṃ brāhmaṇasyāṣṭame / navame pañcame vā kāmyam /	When injunctions of equal force are in conflict with each other, there is an option.* THE STUDENT Time of Initiation A Brahmin's initiation shall be performed in his eighth year, or, if performed with an objective in mind, in his ninth or fifth year.
taddvitīyaṃ janma /	The years are counted from conception. The initiation is a second birth (A ..– n.).
vedānuvacanāc ca /	The teacher is the man from whom one receives initiation or instruction in the Veda.
ekādaśadvādaśayoḥ kṣatriyavaiśyayoḥ /	A Kşatriya's initiation shall be performed in his eleventh year, and a Vaiśya's in his twelfth.
ā ṣoḍaśād brāhmaṇasyāpatitā sāvitrī /	In the case of a Brahmin, the time for the Savitrī does not elapse until the sixteenth year, ¹³ in the case of a Kṣatriya until the twenty-second year, ¹ and in the case of a Vaiśya until two years after that (see A .. f).
mauñjījyāmaurvīsautryo mekhalāḥ krameṇa / kṛṣṇarurubastājināni /	A Student's Code of Conduct Insignia Their girdles are a cord of Muñja grass, a bowstring of Mūrvā, or a cord of thread, respectively; ¹ and their skins are that of a black antelope, a spotted Ruru antelope, and a billy goat, respectively.
kāṣāyam apy eke /	The garments of all students, irrespective of class, are made of hemp, flax, tree bark, or a woollen blanket, or else of raw cotton; some even allow dyed cotton- dyed .
bailvapālāśau brāhmaṇadaṇḍau /	with tree resin for a Brahmin, ¹ and with madder and turmeric for the other two, respectively. A Brahmin's staff is made of wood-apple or Palāśa wood, and those of the other two of banyan and Pīlu wood, respectively.
yajñiyo vā sarveṣām /	Alternatively, for all students, irrespective of class, the staff may be made of any wood suitable for use in a sacrifice.
apīḍitā yūpavakrāḥ saśalkāḥ /	Staffs should be undamaged, bent in the manner of a sacrificial post,* and have their barks intact.
muṇḍajaṭilaśikhājaṭāś ca /	They should reach the crown of the head, the forehead, and the tip of the nose, respectively, for each class. Students may shave their heads completely, wear their hair matted, or keep just the topknot matted.
dravyahasta ucchiṣṭo anidhāyācāmet / dravyaśuddhiḥ parimārjanapradāhatakṣaṇanirṇejanānitaijasamārktikadāravatāntavānām /	Purification If, while holding something in his hand, he happens to become impure, he should sip water without laying it down.* The cleansing of things-articles made of metal, clay, wood, and cloth are cleaned by scrubbing, scorching, scraping, and washing, respectively.
dāruvadasthibhūmyoḥ / āvapanaṃ ca bhūmeḥ / celavad rajjuvidalacarmaṇām /	Stone, gem, shell, and mother-ofpearl are cleaned in the same way as metal; ³¹ bone and mud, in the same way as wood-³ mud also by plastering; ³ and ropes, wicker, and skin, in the same way as cloth.
utsargo vātyantopahatānām /	Articles that have become extremely unclean, on the other hand, should be thrown away.
prāṅmukha udaṅmukho vā śaucam ārabheta /	He should commence his personal purification facing either the east or the north.
śucau deśe āsīno dakṣiṇaṃ bāhuṃ jānvantarākṛtvā yajñopavītyā maṇibandhanāt pāṇī prakṣālya vāgyatohṛdayaspṛśas #	Seated on a clean spot, placing his right arm between his knees, and wearing his upper garment over his left shoulder and under his right arm (A .. n.), he should wash both his hands up to the wrists.
dviḥ parimṛjyate / pādau cābhyukṣet /	n.), wipe his lips twice, sprinkle water on his feet, rub water on the cavities of his head,* and place his hand on the crown of his head.
suptvā bhuktvā kṣutvā ca punaḥ /	After sleeping, eating, and sneezing, he should sip water over again.
dantaśliṣṭeṣu dantavad anyatra jihvābhimarśanāt /	Bits of food sticking between the teeth are like the teeth themselves, unless they are touched with the tongue or, according to some, until they get detached.
prākcyuter ity eke /	When they get detached, a person should .
cyuteśu āsrāvavad vidyān nigirann eva tac śuciḥ /	Dharmasutras know that he is cleansed of them by simply swallowing, just like saliva.
na mukhyā vipruṣa ucchiṣṭaṃ kurvanti na ced aṅgenipatanti / lepagandhāpakarṣaṇe śaucam amedhyasya /	Saliva spattering from the mouth does not make a man impure unless it falls on his body. In the case of filthy substances, purification consists in removing their stains and smell by washing first with water and then with earth and water,* which is done also when urine, excrement, or semen falls on a person, or when one is stained with the remnants of food.
mūtrapurīṣasnehavisraṃsanābhyavahārasaṃyogeṣu ca / yatra cāmnāyo vidadhyāt / pāṇinā savyam upasaṅgṛhya anaṅguṣṭham adhīhi bho ity āmantrayed guruṃ / tatracakṣurmanaḥprāṇopasparśanaṃ darbhaiḥ /	In cases covered by vedic rules, purification is carried out in the manner prescribed in the Veda.* Rules of Study Clasping the teacher's left hand-excluding the thumb-with his right, the pupil should address the teacher: 'Teach, Sir!' Focusing his eyes and mind on the teacher, the pupil should touch his vital organs* with Darbha grass, control his breath three times for fifteen morae each, and sit on a bed of grass with the tips of their blades pointing east.
oṃ pūrvā vyāhṛtayaḥ pañca satyāntāḥ /	The five Calls should begin with OM and end with 'Truth'.* The pupil shall clasp the teacher's feet each morning ³ and also when he begins and ends his vedic recitation.
guroḥ pādopasaṃgrahaṇaṃ prātaḥ /	When he is given permission, he should sit at the teacher's right facing the east or the north.
sāvitrī cānuvacanam / ādito brahmaṇa ādāne / oṃkāro anyatrāpi /	And he should repeat after the teacher the Savitrī verse when he first begins to receive instruction in the Veda, while the syllable OM should be recited also at other times.
antara gamane punar upasadanam /	If someone passes between the teacher and the pupil, this preparatory ceremony should be repeated.
śvanakulasarpamaṇḍūkamārjārāṇāṃ try aham upavāsovipravāsaś ca / prāṇāyāmā ghṛtaprāśanaṃ cetareṣām /	If a dog, a mongoose, a snake, a frog, or a cat passes between them, he should observe a fast for three days and spend some time away from the teacher's house, whereas if it is some other animal, he should control his breath and consume some ghee.
śmaśānābhyadhyayane caivam /	He shall do the same if he happens to recite the Veda in a cemetery.
prāg upanayanāt kāmacāraḥ kāmavādaḥ kāmabhakṣaḥ /	Uninitiated Children ¹Before his initiation, a child may behave, speak, and eat as he pleases.
ahutāt /	He may not partake of ritual offerings and should observe chastity.
brahmacārī /	The set of rules .
yathopapāditamūtrapurīṣo bhavati / nāsyācamanakalpo vidyate /	regarding sipping water and other rituals of purification do not apply to him, other than wiping, washing, and sprinkling with water, ³ and no one is made impure by his touch.
na brahmābhivyāhārayed anyatra svadhāninayanāt /	No one should ever employ him to make fire oblations or Bali offerings, and he should not be made to recite the Veda, except for uttering 'Svadhā'.
upanayanādir niyamaḥ /	General Rules Restrictive rules come into force from the time a person is initiated.
uktaṃ brahmacaryam /	The rule of chastity has already been given.
agnīndhanabhaikṣacaraṇe / satyavacanam / apām upasparśanam / eke godānādi /	He shall put wood into the sacred fire, beg his food, speak the truth, bathe only after the beard-shaving rite, according to some* and perform the twilight worship outside the village.
tiṣṭhet pūrvām āsītottarāṃ sajyotiṣyā jyotiṣodarśanād vāgyataḥ /	Controlling his speech, he should remain standing during the morning twilight worship from the time the stars are still visible until the sun comes into view, and remain seated during the evening from the time the sun is still visible until the stars come into view, ¹ without ever gazing directly at the sun.
gurudarśanekaṇṭhaprāvṛtāvasakthikāpāśrayaṇapādaprasāraṇāni / niṣṭhīvitahasitaviṣkambhitāvasphotanāni / strīprekṣaṇālambhane maithunaśaṅkāyām /	He should abstain from the following: eating honey and meat; wearing perfumes and necklaces; sleeping during the day; applying oil and collyrium; travelling in carriages; using shoes and umbrellas; lust, anger, greed, perplexity, and squabbling; playing musical instruments; bathing and cleaning the teeth (A .. n.); excitement, dancing, singing, calumny, and dangers; ¹ wrapping his neck; sitting cross-legged, leaning against something, or stretching out his feet within sight of his elders; ¹ spitting, laughing, yawning, and cracking his fingers; ¹looking at or touching a woman if there is a hint of sexual intimacy; ¹ gambling, degrading services, taking what is not given, and causing injury to living beings; ¹ uttering the names of his teacher, the teacher's sons and wives, and of persons consecrated for a sacrifice; ¹ and speaking harsh words.
madyaṃ nityaṃbrāhmaṇaḥ /	If he is a Brahmin, he should always abstain from liquor.
adhaḥśayyāsanī pūrvotthāyī jaghanyasaṃveśī /	He shall occupy a bed and seat lower than his teacher's, get up before and go to bed after him, and keep his tongue, arms, and stomach under strict control.
nāmagotre guroḥ samānato nirdiśet /	Conduct towards the Teacher He should utter the personal and lineage names (A ..
śayyāsanasthānāni vihāya pratiśravaṇam /	n.) of his teacher with respect and behave in the same manner towards revered people and his Dharmasutras superiors.
abhikramaṇaṃ vacanād adṛṣṭena / adhaḥsthānāsanas tiryagvātasevāyāṃ gurudarśanecottiṣṭhet /	He should answer his teacher after getting up from his bed or seat ² and go to him when he calls, even if he is out of sight. If he sees his teacher standing or sitting on a lower place or answering the call of nature, he should get up.
gacchantam anuvrajet / karma vijñāpyākhyāya /	If the teacher is walking, he should walk behind him, apprising him of the things to be done and reporting to him what has been done. Let him recite the Veda only when he is called upon to do so and apply himself to doing what is pleasing and beneficial to his teacher.
tadbhāryāputreṣu caivam /	He shall behave in the same manner towards his teacher's wife and sons, with the exception of eating their leftovers (A ..
nocchiṣṭāśanasnāpanaprasādhanapādaprakṣālanonmardanopasaṅgrahaṇāni /	n.), assisting them with their bath or dressing, and washing, rubbing, or clasping their feet.
viproṣyopasaṅgrahaṇaṃ gurubhāryāṇām / naike yuvatīnāṃ vyavahāraprāptena /	When he returns from a journey, he should clasp the feet of his teacher's wives; ³ some maintain that a pupil who has reached the legal age* should not do so in the case of young wives. Food Almsfood may be obtained from people of all classes, excepting heinous sinners (A .. n.) and outcastes.
ādimadhyānteṣu bhavacchabdaḥ prayojyo varṇānukrameṇa /	The word 'Madam' should be placed at the beginning, middle, or end of the request, respectively, according to the class (A .. n.).
ācāryajñātiguruṣv alābhe 'nyatra /	If he does not receive any elsewhere, he may beg from the house of his teacher, a relative, or an elder (A ..
teṣāṃ pūrvaṃ pūrvaṃ pariharet /	n.), or from his own house; let him, however, avoid having to beg from ones given earlier in the list.
nivedya gurave 'nujñāto bhuñjīta / asaṃnidhautadbhāryāputrasabrahmacāribhyaḥ / vāgyatas tṛpyannalolupyamānaḥ saṃnidhāyodakam /	He should eat the almsfood after announcing it to his teacher and with his permission, and, in the absence of the teacher, to his wife or son, or to a fellow student or a virtuous person. Placing some water at his side, let him eat silently and contentedly, but without craving. Punishment A pupil shall be disciplined without resorting to corporal punishment, ³ or, if that is not viable, with a slender rope or cane.
śiṣyaśiṣṭir avadhena /	If the teacher strikes with anything else, the king should punish him.
dvādaśa varṣāṇy ekavede brahmacaryaṃ caret / pratidvādaśa vā sarveṣu /	Conclusion of Study To study a single Veda, he should live as a student for twelve years, and to study all the Vedas, twelve years each or until he has grasped them.
vidyānte gurur arthena nimantryaḥ /	After completing his studies, he should present the teacher with a gift.
kṛtvānujñātasya vā snānam /	After he has done that or after obtaining the teacher's permission, he may take the concluding bath.
ācāryaḥ śreṣṭho gurūṇāṃ /	The teacher is the foremost of his elders (A ..
mātety eke /	n.); according to some, the mother.
tasyāśramavikalpam eke bruvate / brahmacārī gṛhastho bhikṣur vaikhānasaḥ /	ORDERS OF LIFE Argument of Opponents He has a choice, some assert, among the orders of life: student, householder, mendicant, or anchorite (A .. n.).
teṣāṃ gṛhastho yonir aprajanatvād itereṣām /	The householder is their source, because the others do not produce offspring.
tatroktaṃ brahmacāriṇaḥ /	Student Among these, the rules of a student have already been given (A ..n.).
guroḥ karmaśeṣeṇa japet /	n.) during any time that remains after attending to his teacher's business.
tadabhāve vṛddhe sabrahmacāriṇy agnau vā /	When his teacher is no more, he should serve his son; and if there is no son, an older fellow student or the sacred fire.
evaṃvṛtto brahmalokam āpnoti jitendriyaḥ /	A man who conducts himself in this manner attains the world of Brahman and becomes a man who has mastered his senses. All these rules of a student apply to people in subsequent orders as well, so long as they are not inconsistent with the provisions specific to each.
anicayo bhikṣuḥ / ūrdhvaretāḥ /	Mendicant ¹¹A mendicant shall live without any possessions, ¹² be chaste, ¹³ and remain in one place during the rainy season.* ¹ Let him enter a village only to obtain almsfood ¹ and go on his begging round late in the evening, without visiting the same house twice and without pronouncing blessings.
vākcakṣuḥkarmasaṃyataḥ /	He shall control his speech, sight, and actions; and wear a garment to cover his private parts, using, according to some, a discarded piece of cloth after washing it.
na dvitīyām apartu rātriṃ grāme vaset /	He should not pick any part of a plant or a tree unless it has fallen of itself. Outside the rainy season, he should not spend two nights in the same village.
muṇḍaḥ śikhī vā /	He shall be shaven-headed or wear a topknot; refrain from injuring seeds; treat all creatures alike, whether they cause him .
anārambhī /	Dharmasutras harm or treat him with kindness; and not undertake ritual activities.
vaikhānaso vane mūlaphalāśī tapaḥśīlaḥ / śrāvaṇakenāgnim ādhāya / agrāmyabhojī /	Anchorite An anchorite shall live in the forest, living on roots and fruits and given to austerities. He kindles the sacred fire according to the procedure for recluses* and refrains from eating what is grown in a village.
devapitṛmanuṣyabhūtarṣipūjakaḥ / sarvātithiḥ pratiṣiddhavarjam /	He shall pay homage to gods, ancestors, humans, spirits, and seers and entertain guests from all classes, except those who are proscribed.
vaiṣkam apy upayuñjīta /	He may also avail himself of the flesh of animals killed by predators.
grāmaṃ ca na praviśet /	He should not step on ploughed land ³ or enter a village. He shall wear matted hair and clothes of bark or skin and never eat anything that has been stored for more than a year.
ekāśramyaṃ tv ācāryāḥ pratyakṣavidhānādgārhasthasya gārhasthasya /	Author's Judgement There is, however, only a single order of life,* the Teachers maintain, because the householder's state alone is prescribed in express vedic texts.* THE HOUSEHOLDER Marriage ¹A householder should marry a wife who comes from the same class as he, who has not been married before, and who is younger than he.
ūrdhvaṃ saptamāt pitṛbandhubhyo /	A marriage can be contracted only between persons not belonging to a family with the same ancestral seer (A .. n.) ³ and not related within six degrees on the side of the legal or the biological father (cf.
mātṛbandhubhyaḥ pañcamāt /	G .–), or within four degrees on the mother's side.
brāhmo vidyācāritrabandhuśīlasaṃpannāya dadyādācchādyālaṃkṛtām /	Types of Marriage When one dresses up a girl, adorns her with jewellery, and gives her to a man of learning, character, and virtue who has relatives, it is a ‘Brahma' marriage.
saṃyogamantraḥ prājāpatye saha dharmaś caryatām iti /	At a 'Prajāpati' marriage, the nuptial formula is 'May you jointly fulfil the Law'.
ārṣe gomithunaṃ kanyāvate dadyāt /	At a 'Seer's' marriage, the bridegroom should give a bull and a cow to the father of the girl. When one adorns a girl with jewellery and gives her to the officiating priest within .
antarvedyṛtvije dānaṃ daivo 'laṃkṛtya /	the sacrificial arena, it is a 'Divine' marriage.
icchantyāḥ svayaṃ saṃyogo gāndharvaḥ /	When a man on his own has intercourse with a willing woman, it is a 'Gandharva' marriage.
vittenānatiḥ strīmatām āsuraḥ / prasahyādānād rākṣasaḥ /	When a man courts the guardians of the girl with money, it is a 'Demonic' marriage. When a man abducts her by force, it is a 'Fiendish' marriage.
asaṃvijñātopasaṃgamāt paiśācaḥ /	When a man has intercourse with an unconscious girl, it is a 'Ghoulish' marriage.
catvāro dharmyāḥ prathamāḥ /	The first four types are in accordance with the Law; ¹ the first six, according to some.
brāhmaṇy ajījanat putrān varṇebhya ānupūrvyādbrāhmaṇasūtamāgadhacaṇḍālān / tebhya eva kṣatriyāmūrdhāvasikthakṣatriyadhīvarapulkasāṃs / tebhya eva vaiśyābhṛjjakaṇṭhamāhiṣyavaiśyavaidehān /	Mixed Classes Children born in keeping with the natural order of classes from women of the class immediately below the man's are Savarṇas, Ambaṣṭhas, and Ugras; from women two classes below the man's, Niṣādas and Dauṣyantas; and from women three classes below the man's, Pāraśavas. Children born in the reverse order of classes from women of the class immediately above the man's are Sūtas, Māgadhas, and Ayogavas; from women two classes above the man's, Kṣattṛs and Vaidehas; and from women three classes above the man's, Cāṇḍālas. From men of the four classes, a Brahmin woman gives birth respectively to Brahmins, Sūtas, Māgadhas, and Cāṇḍālas; from the same men, a Kṣatriya woman gives birth respectively to Mūrdhāvasiktas, Kṣatriyas, Dhīvaras, and Pulkasas; º from the same men, a Vaiśya woman gives birth respectively to Bhrjyakaṇṭhas, Māhiṣyas, Vaiśyas, and Vaidehas; ¹ and from the same men, a Śūdra woman gives birth respectively to Pāraśavas, Yavanas, Karaṇas, and Śūdras.
pāraśavayavanakaraṇaśūdrāñ śūdrety eke / varṇāntaragamanam utkarṣāpakarṣābhyāṃsaptame pañcame vācāryāḥ /	That is the opinion of some. By successively marrying persons of the higher or the lower class, in the seventh generation the offspring moves to the one or the other class; in the fifth, according to the Teachers.
sṛṣṭyantarajātānāṃ ca /	This is true also in the case of those born to parents belonging to different mixed classes.
pratilomās tu dharmahīnāḥ / śūdrāyāṃ ca / asamānāyāṃ tu śūdrāt patitavṛttiḥ /	Children born to parents in the reverse order of classes, on the other hand, are outside the Law, as also those born to a Śūdra woman.* A child of a Śūdra man from a woman of a different class shall be treated like an outcaste, the one listed last being the vilest.
punanti sādhavaḥ putrāḥ /	Sons Virtuous sons purify- a son born from a 'Seer's' .
tripuruṣam ārṣāt / daśa daivād /	Dharmasūtras marriage purifies three ancestors; a son born from a 'Divine' marriage, ten; ³ a son born from a 'Prajāpati’ marriage, also ten; while a son born from a 'Brahma' marriage purifies the ten ancestors before him and the ten descendants after him.
daśaiva prājāpatyāt /	Rules of Sexual Intercourse ¹A man should have sexual intercourse with his wife when she is in her season (A ..
sarvatra vā pratiṣiddhavarjam /	n.), ² or at any time, except on days when it is forbidden.
devapitṛmanuṣyabhūtarṣipūjakaḥ /	Ritual Duties ³ He shall pay homage to gods, ancestors, humans, spirits, and seers.
pitṛbhyaś codakadānaṃ / yathotsāham anyat / bhāryādir agnir dāyādir vā /	Every day he shall perform his private vedic recitation, the offering of water to his ancestors, and other rites, according to his ability. Let him set up his sacred fire either on the day of his marriage or upon the division of the paternal estate ³ and perform in it his domestic rites, as well as sacrifices to gods, ancestors, and humans, private vedic recitation, and Bali offerings.
agnāv agnir dhanvantarir viśve devāḥ prajāpatiḥsviṣṭakṛd iti homaḥ /	Fire oblations are offered to Fire, Dhanvantari, All-Gods, Prajāpati, and Fire who makes the offering flawless.
dvārṣu mahadbhyaḥ / gṛhadevatābhyaḥ praviśya / brahmaṇe madhye /	Oblations are offered also to the guardian deities of the directions, each in his respective place-¹ to the Maruts at the doors to the house, ¹ to the guardian deities of the house after entering the house, ¹ to Brahman at the centre of the house, ¹ to the waters by the water pot, ¹to space in the intermediate region, ¹ and to night-stalkers in the evening.
adbhya udakumbhe /	Gifts ¹ He shall give almsfood after getting the recipient to wish him well and pouring water.
dadātiṣu caivaṃ dharmyeṣu /	The same applies to other righteous (dharma) gifts.
samadviguṇasāhasrānantyāni phalānyabrāhmaṇabrāhmaṇaśrotriyavedapāragebhyaḥ /	A gift bears an equal reward when it is given to a non-Brahmin, twice as much when it is given to a Brahmin, a thousand times as much when it is given to a vedic scholar, and an infinite reward when it is given to one who has mastered the entire Veda.
gurvarthaniveśauṣadhārthavṛttikṣīṇayakṣyamāṇādhyayanādhvasaṃyogavaiśvajiteṣu dravyasaṃvibhāgo bahirvedi /	Goods should be distributed outside the sacrificial arena to those begging in order to pay the teacher's fee, to . perform a wedding, or to procure medicine, as also to the indigent, to those preparing to perform a sacrifice, to students, to travellers, and to those who have offered the Viśvajit sacrifice.
bhikṣamāṇeṣu kṛtānnam itareṣu /	When others come to beg, let him give them cooked food.
pratiśrutyāpy adharmasaṃyuktāya na dadyāt /	When a request is made for an unlawful (adharma) purpose, he should not give, even if he has already promised to do so.
kruddhahṛṣṭabhītārtalubdhabālasthaviramūḍhamattonmattavākyānyanṛtānyapātakāni /	Untrue statements made by people who are angry, jubilant, afraid, in pain, greedy, young, old, feeble-minded, drunk, or mad are not sins causing loss of caste.
bhojayet pūrvamatithikumāravyādhitagarbhiṇīsvavāsinīsthavirāñ jaghanyāṃś /	Guests He should give food first to guests, children, the sick, pregnant women, females in his household, and the old, as well as the menials.
ācāryapitṛsakhīnāṃ ca nivedya pacanakriyā /	When his teacher, father, or friend is visiting, however, he should check with them before cooking the meal.
ṛtvigācāryaśvaśurapitṛvyamātulānām upasthānemadhuparkaḥ /	When his officiating priest, teacher, father-in-law, or paternal or maternal uncle visits him, he shall offer them the honey mixture (A ..).
samvatsare punaḥ / yajñavivāhayor arvāk /	It needs to be repeated only after the interval of a year; but on the occasion of a sacrifice or a wedding, it should be repeated even if a year has not elapsed.
rājñaś ca śrotriyasya / aśrotriyasyāsanodake /	It should also be offered to a king and to a vedic scholar.* To a Brahmin who is not a vedic scholar, he should offer a seat and water; but to one who is a vedic scholar he should have water for washing the feet and the welcome water* prepared, as also lavish food or the normal food prepared in a special way.
madhyato 'nnadānam avaidye sādhuvṛtte / viparīteṣutṛṇodakabhūmi /	To a Brahmin without vedic learning but of good conduct, he should give average food; ³ but to one with the opposite qualities, just some straw and water, and a place on the floor, ³ or at the very least, a word of welcome.
svāgatam antataḥ /	He should show respect to the guest and not eat before him.
pūjānatyāśaś ca / śayyāsanāvasathānuvrajyopāsanāni sadṛkśreyasoḥsamānāni / alpaśo 'pi hīne /	To those who are his equals or superiors, he should offer a room, bed, and seat as good as his; treat them hospitably; and follow them as they leave; somewhat less than that if it is a man inferior to him.
asamānagrāmo 'tithiraikarātriko 'dhivṛkṣasūryopasthāyī /	A guest is defined as a man from a different village who comes when the sun is setting behind the trees to spend just one night.
kuśalānāmayārogyāṇām anupraśnaḥ /	He should ask him whether he is doing well; or whether Dharmasutras .
antyaṃ śūdrasya /	he is in good shape; or whether he is in good health, in accordance with his class (A ..- n.), ² the last being used in the case of a Śūdra.
brāhmaṇasyānatithir abrāhmaṇaḥ /	A non-Brahmin is never a guest of a Brahmin, unless he has come on the occasion of a sacrifice.
bhojanaṃ tu kṣatriyasyordhvaṃ brāhmanebhyaḥ /	A Kṣatriya, however, should be fed after the Brahmins, and the others should be fed together with his servants to show compassion.
mātṛpitṛtadbandhūnāṃ pūrvajānāṃ vidyāgurūṇāṃtadgurūṇāṃ ca /	Salutation - His mother and father, their relations, his older brothers, his teachers, and their teachers-each day when he meets them he should clasp their feet, as also when he returns from a journey.
saṃnipāte parasya /	When he meets several of them together, he should first clap the feet of the one who is most superior.
svanāma procyāhamayam ity abhivādojñasamavāye /	When he meets a knowledgeable person, he should greet him by stating his own name and saying, 'I am so-and-so'.
strīpuṃyoge 'bhivādato 'niyamam eke /	Some say that there is no restrictive rule about salutation between husband and wife.
nāviproṣya strīṇām amātṛpitṛvyabhāryābhaginīnām / nopasaṃgrahaṇaṃ bhrātṛbhāryāṇāṃ svasṛṛṇām /	Except upon returning from a journey, there is no need to greet women other than his mother, paternal uncle's wife, and his sisters; nor should he clasp the feet of his brothers' wives or his mother-in-law. In the case of an officiating priest, a father-inlaw, or a paternal or maternal uncle who is younger than himself, on the other hand, he should rise up to receive him but there is no need to offer a formal greeting.
avaro 'py āryaḥ śūdreṇa /	An aged fellow townsman or even an -year-old Sūdra should be treated in the same way by a man young enough to be his son, ¹¹as also an Ārya even younger than himself, by a Śūdra.
nāma vāsya varjayet /	Such a person, moreover, should refrain from saying the other's name, as also a royal officer who has not studied the Veda, the name of the king.
daśavarśavṛddhaḥ pauraḥ /	A friend born on the same day as oneself should be addressed 'Mister!' or 'Sir!", ¹ as also a fellow townsman ten years older than oneself; ¹an artist five years older; ¹ a vedic scholar of one's own vedic branch (p.
śrotriyaś cāraṇas tribhiḥ /	xxii) who is three years older; ¹an ignorant Brahmin following the occupations of a Kṣatriya or a Vaiśya; ¹ and a man consecrated for a sacrifice before the purchase of Soma (A ..
śrutaṃ tu sarvebhyo garīyaḥ / tanmūlatvād dharmasya	n.). Rules of Precedence People should be honoured on account . of wealth, relatives, occupation, birth, learning, and age, but each succeeding one is more important than each preceding, ¹ but vedic learning is the most important of all, because it is the source of Law and because it is so stated in the vedic texts.
cakridaśamīsthānugrāhyavadhūsnātakarājabhyaḥ pathodānam /	One must yield the way to people in vehicles, extremely old people, the sick,* women, bath-graduates (A ..
rājñā tu śrotriyāya śrotriyāya /	n.) and kings; and a king to a vedic scholar.
anugamanaṃ śuśrūṣā /	Times of Adversity ¹These are the rules for times of adversity.
samāpte brāhmaṇo guruḥ /	A Brahmin may receive vedic instruction from a non-Brahmin, walk behind him, and obey him. Once the study is completed, however, the Brahmin becomes the more honourable of the two.
yājanādhyāpanapratigrahāḥ sarveṣām / pūrvaḥ pūrvo guruḥ /	One may teach, officiate at the sacrifices of, and receive gifts from people of all classes, each preceding occupation being more honourable.
tadalābhe kṣatravṛttiḥ / tadalābhe vaiśyavṛttiḥ /	When these occupations are unavailable, one may live by the occupations of a Ksatriya, and when even these are unavailable, by the occupations of a Vaisya.
mūlaphalapuṣpauṣadhamadhumāṃsatṛṇodakāpathyāni /	One may not trade in the following goods: 'perfumes, condiments, prepared foods, sesame seeds, hemp or linen cloth, skins, garments that are dyed red or washed, milk and milk products, ¹ roots, fruits, flowers, medicines, honey, meat, grass, water, poisons, ¹ and animals for slaughter; ¹and, under any circumstance, human beings, barren cows, heifers, and pregnant cows.
bhūmivrīhiyavājāvyaśvaṛṣabhadhenvanaḍuhaś caike /	According to some, one may also not trade in land, rice, barley, goats, sheep, horses, bulls, milch-cows, and oxen.
rasānāṃ rasaiḥ /	One is restricted to bartering ¹ condiments for condiments ¹ and animals for animals; ¹but not salt, prepared food, or sesame seeds.
samenāmena tu pakvasya saṃpratyarthe /	One may, however, exchange uncooked food for an equal amount of cooked food for immediate use.
sarvathā vṛttir aśaktāv aśaudreṇa / tad apy eke prāṇasaṃśaye /	When none of this is possible, however, one may sustain oneself by any occupation except that of a Sudra; some permit even that when one's life is at stake.
tadvarṇasaṃkarābhakṣyaniyamas tu /	Even then, however, one is not allowed to mix with that class or to eat forbidden food.
prāṇasaṃśaye brāhmaṇo 'pi śastram ādadīta /	When his life is at stake, even a Brahmin may live by the use of arms, and a Kṣatriya may resort to the occupations of a Vaisya.
dvau loke dhṛtavratau rājā brāhmaṇaś ca bahuśrutaḥ /	Dharmasutras The Brahmin and the King ¹ There are in the world two who uphold the proper way of life-the king and the Brahmin deeply learned in the Vedas.
tayoś caturvidhasya manuṣyajātasyāntaḥsaṃjñānāmcalanapatanasarpaṇānām āyattaṃ jīvanam /	And on them depend the life of the fourfold human race and of internally conscious creatures that move about, fly, and crawl; ³ as well as their increase, protection, non-intermixture, and adherence to the Law.
sa eva bahuśruto bhavati / lokavedavedāṅgavit / vākovākyetihāsapurāṇakuśalaḥ /	He alone is deeply learned in the Vedas who knows the secular sciences, the Vedas, and the Vedic Supplements; who is well read in the dialogues, epics, and Purāṇas; who relies on them and patterns his conduct after them; who has been sanctified by the forty sacramentary rites (G .-); who is devoted to the three occupations or to the six (G .-); and who has been trained in the accepted customary Laws (A .. n.).
ṣaḍbhiḥ parihāryo rājñā /	The king should exempt such a man from six things: ¹ he should not be subjected to corporal punishment, imprisonment, fines, banishment, upbraiding, and abandonment.
catvāri vedavratāni / snānaṃ sahadharmacāriṇīsaṃyogaḥ / pañcānāṃ yajñānām anuṣṭhānaṃdevapitṛmanuṣyabhūtabrāhmaṇām /	Sacramentary Rites ¹Impregnation rite, quickening a male foetus, parting the wife's hair, birth rite, naming, first feeding with solid food, tonsure, and initiation;* the four vows* associated with vedic study; ¹bath at the conclusion of study, marrying a helpmate in fulfilling the Law, and performing the five sacrifices to gods, ancestors, humans, spirits, and Veda (A .. f.); ¹ as well as of the following: ¹ the seven kinds of sacrifices using cooked food, viz., ancestral offerings on the eighth day after the full moon, offerings on full-moon and new-moon days, ancestral offerings, and offerings on the full-moon days that open a four-month season (A .. n.); the seven kinds of sacrifices with burnt offerings, viz., setting up the vedic fires, daily fire offering, newand full-moon sacrifices, sacrifice of first fruits, seasonal sacrifices, Nirūḍhapaśubandha, and Sautrāmaṇī; º the seven kinds of Soma sacrifices, viz., Agnișțoma, Atyagniṣṭoma, Ukthya, Șodasin, Vājapeya, Atirātra, and Aptoryāma—²¹ these are the forty sacramentary rites.
athāṣṭāv ātmaguṇāḥ /	Virtues Next, the eight virtues of the self: compassion towards all creatures, patience, lack of envy, purification, tranquillity, having an auspicious disposition, generosity, and lack of greed.
yasyaite catvāriṃśatsaṃskārā na cāṣṭāv ātmaguṇāna sa brahmaṇaḥ sāyujyaṃ sālokyaṃ gacchati / yasya tu khalu saṃskārāṇām ekadeśo 'py aṣṭāv ātmaguṇā atha sa brahmaṇaḥ sāyujyaṃ sālokyaṃ cagacchati /	A man who has performed the forty sacramentary rites but lacks these eight virtues does not obtain union with or residence in the same world as Brahman. A man who may have performed only some of the forty sacramentary rites but possesses these eight virtues, on the other hand, is sure to obtain union with and residence in the same world as Brahman. THE BATH-GRADUATE ¹Such a man (A ..
sa vidhipūrvakaṃ snātvā bhāryām adhigamyayathoktān gṛhasthadharmān prayuñjāna imāni vratāny anukarṣet /	n.), after he has completed his studies, should bathe according to the rules (A .. n.), marry a wife, and, as he continues to observe the Laws proper to a householder described above, subject himself to the following VOWS.
nityaṃ śuciḥ sugandhiḥ snānaśīlaḥ /	He shall always keep himself clean and smelling good and cultivate the habit of bathing.
na raktam ulbaṇam anyadhṛtaṃ vāso bibhṛyāt / na sragupānahau /	If he has the means, he should not wear old or dirty clothes, nor ones that are dyed red or costly, or that have been worn by others- not even garlands or shoes; if he does not have the means, he should wash the garment before wearing it.
nāgnim apaś ca yugapad dhārayet / nāñjalinā pibet /	Let him not grow his beard without a good reason.* He should not carry fire and water at the same time; ºdrink water from his cupped hands; stand while he sips water that has been drawn out;* or sip water given by a Sūdra or an impure person, or taken with one hand.
na vāyvagniviprādityāpo devatā gāś ca pratipaśyan vā mūtrapurīṣāmedhyān vyudasyet /	He should not discharge urine, excrement, or bodily filth facing or looking at the wind, a fire, a Brahmin, the sun, water, a divine image, or a cow; nor should he stretch his feet towards any of these divinities.
na parṇaloṣṭāśmabhir mūtrapurīṣāpakarṣaṇaṃ kuryāt /	He should not use leaves, clods, or stones to clean himself of urine or excrement; stand on ashes, hair, potsherds, or filth; or converse with barbarians or with sordid (A ..-) or unrighteous people.
brāhmaṇena vā saha saṃbhāṣeta /	If he happens to converse with them, he should mentally reflect on virtuous men or speak with a Brahmin.
adhenuṃ dhenubhavyeti brūyāt / abhadraṃ bhadram iti /	When speaking of a cow that does not yield milk, he should . Dharmasutras say 'She is going to be a milch-cow'; and when speaking of something unlucky, he should say 'It's a lucky thing'.
kapālaṃ bhagālam iti / maṇidhanur itīndradhanuḥ /	In referring to a skull, he should use the word bhagāla in place of kapāla;* and in referring to a rainbow, the word manidhanus ('jewelled bow') in place of indradhanus ('Indra's bow': see A ..).
na cainām vārayet /	He should neither inform anyone that a cow is suckling her calf nor prevent her from doing so.
na ca tasmin śayane svādhyāyam adhīyīta / na cāpararātram adhītya punaḥ pratisaṃviśet /	After engaging in sexual intercourse, he should not be tardy in purifying himself. And he should not do his private vedic recitation sitting on the same bed.
na caināṃ śliṣyen / na kanyām /	n.), moreover, he should not go back to bed. He should not have intercourse with his wife when she is indisposed or having her period, ⁰ or embrace her when she is in that state. Neither should he embrace an unmarried girl.
na sandigdhāṃ nāvam adhirohet /	n.); climbing trees; climbing on to or descending into dangerous places; and putting his life in danger. He should not get into an unsafe boat.
sarvata evātmānaṃ gopāyet /	Let him take care of himself in every possible way.
na prāvṛtya śiro 'hani paryaṭet /	He should cover his head also when he is voiding urine or excrement, which he should never do without spreading something on the ground (A ..
mūtroccāre ca /	n.), ⁹ or close to his house, or upon ashes or cow-dung, on a ploughed field, in a shadow, on a road, or in a beautiful spot.
ubhe mūtrapurīṣe tu divā kuryād udaṅmukhaḥ /	He should void both urine and excrement facing the north during the day and at dawn and dusk, but facing the south at night.
saṃdhyayoś ca /	n.; .. n.) and refrain from eating, sitting, greeting, or paying homage with his shoes on.
na pūrvāhṇamadhyaṃdināparāhṇān aphalān kuryādyathāśakti dharmārthakāmebhyaḥ /	He should not spend the morning, midday, or afternoon fruitlessly, but pursue righteousness, wealth, and pleasure to the .
teṣu tu dharmottarah syāt /	best of his ability, but among them he should attend chiefly to righteousness (A .. n.).
na nagnāṃ parayoṣitam īkṣeta /	He should not look at someone else's wife when she is naked, or draw a seat to himself with his foot.
na śiśnodarapāṇipādavākcakṣuścāpalāni kuryāt /	He should not let his penis, stomach, hands, feet, speech, or sight get out of control; ¹ engage in cutting, breaking, gashing, or crushing anything or in cracking the finger joints without a good reason; or step over a rope to which a calf is tied.
na yajñam avṛto gacchet /	Let him not carry tales from one family to another.* He should not go to a sacrifice unless he has been chosen to officiate, but he may go there freely to witness it.
na kadācid rātrau nagnaḥ svapet / snāyād vā /	He should not eat food placed in his lap or brought at night by a servant; ar and foods whose nutrients have been extracted, such as de-creamed milk products, whey, oil-press residue, and buttermilk. Morning and evening, however, he should take his meal, revering the food and never disparaging it. He should never sleep naked at night, or bathe naked.
yac cātmavanto vṛddhāḥ samyagvinītādambhalobhamohaviyuktā vedavida ācakṣate tat samācaret /	And whatever people who are self-possessed, elderly, properly trained, and free from hypocrisy, greed, and perplexity, and who know the Vedas instruct him to do, he should carry it out.
nānyam anyatra devagurudhārmikebhyaḥ /	He may approach the king for the sake of a livelihood, but not anyone else except gods,* elders, and righteous people.
prabhūtaidhodakayavasakuśamālyopaniṣkramaṇamāryajana bhūyiṣṭham analasasamṛddhaṃ dhārmikādhiṣṭhitaṃ niketanamāvasituṃ #	He should try to live in a place well supplied with firewood, water, fodder, Kuśa grass, and garland material; served by many roads; inhabited mainly by Aryas; full of energetic people; and ruled by a righteous man (B ..).
praśastamaṅgalyadevatāyatanacatuṣpadam pradakṣiṇam āvarteta /	When he passes people or things that are distinguished or auspicious, as also temples, intersections of two roads, and the like, he should keep his right side towards them (A ..
satyadharmā / āryavṛttiḥ / śiṣṭādhyāpakaḥ /	n.). The rule for times of adversity is that he should observe all the rules of conduct mentally. He shall speak the truth; behave like an Arya; º teach only cultured men; ¹ be cultured by adhering to ritual purifications; ² take delight in the vedic texts; never hurt any creature; be gentle and steadfast; and be devoted to self-control and gift giving.
evam ācāro mātāpitarau pūrvāparāṃś ca sambandhānduritebhyo mokṣayiṣyan snātakaḥ śaśvadbrahmalokān na cyavate na #	A bath-graduate who lives in this manner will liberate his parents and his relatives of past and future generations from sins, and he will never fall from the world of Brahman.
dvijātīnām adhyayanam ijyā dānam /	Dharmasūtras OCCUPATIONS OF THE FOUR CLASSES Study, sacrifice, and giving gifts pertain to all twiceborn classes. Brahmin In addition to these, teaching, officiating at sacrifices, and receiving gifts pertain to Brahmins, ³but only the former are obligatory.
ācāryajñātipriyagurudhanavidyāniyameṣu brahmaṇaḥsaṃpradānam anyatra yathoktāt / kṛṣivāṇijye vāsvayaṃkṛte / kusīdaṃ ca /	Vedic instruction may be imparted outside the above mentioned rules to a teacher, relative, friend, or elder (A .. n.), or when it is imparted in exchange for knowledge or money. A Brahmin may also engage in agriculture and trade if he does not do the work himself, and in lending money on interest.
rājño 'dhikaṃ rakṣaṇaṃ sarvabhūtānām /	King and Ksatriya To a king pertains, in addition, the protection of all creatures, as also meting out just punishment.
nirutsāhāṃś ca brāhmaṇān / akarāṃś ca /	He should support Brahmins who are vedic scholars, ¹ non-Brahmins who are unable to work, ¹¹those who are exempt from taxes, ¹² and novice students (A .. n.).
yogaś ca vijaye / bhaye viśeṣeṇa / caryā ca rathadhanurbhyām /	War He should also take measures to ensure victory, ¹especially when danger threatens; ¹ travel about in a chariot armed with a bow; ¹ and stand firm in battle without fleeing.
kṣatriyaś ced anyas tam upajīvet tadvṛttyā /	He commits no sin if he kills someone in battle, ¹ except the following: those who have lost their horses, charioteers, or arms; those who join their hand in supplication or have dishevelled hair; those who are fleeing or hunkering down; those who have climbed on to a ledge or a tree; messengers; and those who say they are cows or Brahmins.* ¹ If another Kşatriya depends on the king for his livelihood, he too must participate in the king's undertakings.
vāhanaṃ tu rājñaḥ /	The victor should take the booty of battle, ¹ but the mounts* go to the king, as well as a choice portion of the booty unless it has been won in single combat.
anyat tu yathārhaṃ bhājayed rājā /	Everything else, however, the king should distribute equitably among his men.
rājño balidānaṃ karṣakairdaśamam aṣṭamaṃ ṣaṣṭhaṃ vā /	Taxes Farmers shall pay one-tenth, or one-eighth, or onesixth of their produce to the king as taxes.
paśuhiraṇyayor apy eke pañcāśadbhāgaḥ /	According to some, there is a tax of one-fiftieth on cattle and gold.
mūlaphalapuṣpauṣadhamadhumāṃsatṛnendhanānāṃṣaṣṭhaḥ /	There is a duty of one-twentieth on merchandise, and one-sixtieth on roots, fruits, flowers, medicine, honey, meat, grass, and firewood.
tadrakṣaṇadharmitvāt / teṣu tu nityayuktaḥ syāt / adhikena vṛttiḥ /	The grounds for taxation is the king's duty to protect the people; he should always be attentive to them.* The king shall obtain his livelihood by means of this additional duty of his.
śilpino māsi māsy ekaikaṃ karma kuryuḥ /	Every month each artisan shall work one day for the king.
naucakrīvantaś ca /	This applies also to people who live by manual labour and to those who operate boats and carriages.
bhaktaṃ tebhyo dadyāt /	The king should give them food when they work for him. Every month traders should give the king a piece of merchandise below its market value.
ūrdhvam adhigantuś caturthaṃ rājñaḥ śeṣaḥ /	Ownership If someone finds lost property whose owner is unknown, he should disclose it to the king. The king should have it publicized and keep it safely for a year, after which time a quarter goes to the finder and the rest to the king.
brāhmaṇasyādhikaṃ labdham / kṣatriyasya vijitam / nirviṣṭaṃ vaiśyaśūdrayoḥ /	Ownership is established by inheritance, purchase, partition, possession, and discovery; additionally, acceptance for Brahmins, ¹ conquest for Kṣatriyas, and wages for Vaiśyas and Śūdras.
nidhyadhigamo rājadhanam /	A treasure-trove is the property of the king, except when it is found by an upright Brahmin.
brāhmaṇasyābhirūpasya / abrāhmaṇo 'py ākhyātā ṣaṣṭhaṃ labhetety eke /	According to some, even a non-Brahmin who discloses a find should receive onesixth.
caurahṛtam apajitya yathāsthānam gamayet / kośād vā dadyāt /	When property is stolen by thieves, the king should recover it and return it to its rightful owner or pay compensation from his treasury.
rakṣyaṃ bāladhanam ā vyavahāraprāpaṇāt /	He should keep the property of children safely until they reach the legal age (G .
samāvṛtter vā /	n.) or have completed their studies.
śūdraś caturtho varṇa ekajātiḥ /	Vaisya and Śūdra To a Vaisya pertain in addition agriculture, trade, animal husbandry, and lending money on interest. The Sūdra is the fourth class with a single birth (A ..- n.).
tasyāpi satyam akrodhaḥ śaucam /	Speaking the truth, refraining from anger, and . Dharmasutras purification apply to him also.
ācamanārthe pāṇipādaprakṣālanam evaike /	According to some, he should simply wash his hands and feet in place of sipping water.
bhṛtyabharaṇam / svadāravṛttiḥ / paricaryā cottareṣām /	He should make ancestral offerings; support his dependants; be faithful to his wife; 'serve the upper classes; seek his livelihood from them; use their discarded shoes, umbrellas, clothes, and mats and the like; and eat their leftovers (A ..
śilpavṛttiś ca /	n.). He may also support himself by working as an artisan.
yaṃ cāryam āśrayed bhartavyas tena kṣīṇo 'pi / tena cottaraḥ /	The Ārya whom he serves must support him even when he is unable to work, and under similar circumstances he should support the upper-class man using his savings for that purpose.
anujñāto 'sya namaskāro mantraḥ /	When he is given leave, he may use the word 'Homage!' as his mantra.
pākayajñaiḥ svayaṃ yajetety eke /	According to some, he may offer sacrifices on his own using cooked food.
sarve cottarottaraṃ paricareyuḥ /	All should serve the people belonging to classes higher than themselves.
āryānāryayor vyatikṣepe karmaṇaḥ sāmyaṃ /	If Aryas do the jobs of non-Aryas and vice versa, they become equal.
rājā sarvasyeṣṭe brāhmanavarjam /	THE KING The king rules over all except Brahmins. He should be correct in his actions and speech ³ and trained in the triple Veda and logic.
sādhukārī sādhuvādī /	Let him be upright, keep his senses under control, surround himself with men of quality, and adopt sound policies. He should be impartial towards his subjects and work for their welfare.
samaḥ prajāsu syāt /	As he sits on a high seat, all except Brahmins should pay him homage seated at a lower level, and even Brahmins should honour him.
varṇān āśramāṃś ca nyāyato 'bhirakṣet / calataś caitān svadharme sthāpayet /	He should watch over the social classes and the orders of life in conformity with their rules, ¹ and those who stray he should guide back to their respective duties (dharma), ¹¹ for the king,' it is stated, ‘takes a share of their merits (dharma).' He should appoint as his personal priest a Brahmin who is learned, born in a good family, eloquent, handsome, mature, and virtuous; who lives according to the rules; and who is austere.
brahmaprasūtaṃ hi kṣattram ṛdhyate na vyathata iti cavijñāyate /	He should undertake rites only with his support, ¹for a Kṣatriya, when he is supported by a Brahmin,' it is said, 'prospers and never falters.' ¹ He should also pay heed to what his astrologers and augurs tell him, for, according to some, his .
tadadhīnam api hy eke yogakṣemaṃ pratijānate /	welfare* depends also on that.
śāntipuṇyāhasvastyayanāyuṣmanmaṅgalasaṃyuktānyābhyudayikāni vidveṣaṇasaṃvananābhicāradviṣadvyṛddhiyuktāni caśālāgnau #	In the fire within the assembly hall, he should perform rites to secure prosperity in connection with a propitiation, festive day, military expedition, long life, or auspiciousness, as well as rites to stir enmity, to subdue or slay his enemies, or to bring them to their knees.
yathoktam ṛtvijo 'nyāni /	His officiating priests shall carry out the other rites as prescribed.
tasya ca vyavahāro vedo dharmaśāstrāṇy aṅgānyupavedāḥ purāṇam / deśajātikuladharmāś cāmnāyair aviruddhāḥ pramāṇam /	The Judicial Process His administration of justice shall be based on the Veda, the Legal Treatises, the Vedic Supplements (A ..–), and the Purāņa. The Laws of regions, castes, and families are also authoritative if they are not in conflict with the sacred scriptures.
karṣakavaṇikpaśupālakusīdikāravaḥ sve sve varge /	Farmers, merchants, herdsmen, moneylenders, and artisans exercise authority over their respective groups.
tebhyo yathādhikāram arthān pratyavahṛtyadharmavyavasthā /	should dispense the Law after he has ascertained the facts from authoritative persons of each group.
nyāyādhigame tarko 'bhyupāyaḥ /	He Reasoning is the means of reaching a correct judgment.
tenābhyūhya yathāsthānaṃ gamayet /	Having reached a conclusion in this manner, he should decide the case equitably.
vipratipattau traividyavṛddhebhyaḥ pratyavahṛtyaniṣṭhāṃ gamayet /	If there is conflicting evidence, he should consult those who are deeply learned in the triple Veda and reach a decision, for, it is said, acting in that way, he will attain prosperity.
brahma kṣattreṇa saṃpṛktaṃ devapitṛmanuṣyāndhārayatīti vijñāyate / daṇḍo damanād ity āhus tenādāntān damayet /	Punishment 'Brahmins united with Kşatriyas', it is stated, 'uphold the gods, ancestors, and human beings.' The word 'punishment' (danda), they say, is derived from ‘restraint' (damana); therefore, he should restrain those who are unrestrained.
varṇāśramāḥ svasvadharmaniṣṭhāḥ pretya karmaphalamanubhūya tataḥ śeṣena viśiṣṭadeśajātikularūpāyuḥśrutacitravittasukhamedhaso janma pratipadyante /	People belonging to the different classes and orders of life who are steadfastly devoted to the Laws proper to them enjoy the fruits of their deeds after death; and then, with the residue of those fruits, take birth again in a prosperous region, a high caste, and a distinguished family, with a handsome body, long life, deep vedic learning, and virtuous conduct, and with great wealth, happiness, and intelligence.
viṣvañco viparītā naśyanti /	Those who act to the contrary disperse in every direction and perish.
tasmād rājācāryāv anindyāv anindyau /	The teacher's . advice and the king's punishment protect them; ³ therefore, one should never belittle the king or the teacher.
śūdro dvijātīn abhisaṃdhāyābhihatya cavāgdaṇḍapāruṣyābhyām aṅgamocyo yenopahanyāt /	Dharmasutras Criminal and Civil Law Abuse and Assault ¹If a Śūdra uses abusive language or physical violence against twice-born people (A .. n.), the part of his body used for the crime should be chopped off.
āryastryabhigamane liṅgoddhāraḥ svaharaṇaṃ ca / goptā ced vadho 'dhikaḥ /	If he has sex with an Arya woman, his penis should be cut off and all his property confiscated; ³ if the woman had a guardian, then, in addition to the above, he shall be executed.
atha hāsya vedam upaśṛṇvatas trapujatubhyāṃśrotrapratipūraṇam / udāharaṇe jihvācchedo /	And if he listens in on a vedic recitation, his ears shall be filled with molten tin or lac; if he repeats it, his tongue shall be cut off; if he commits it to memory, his body shall be split asunder.
āsanaśayanavākpathiṣu samaprepsur daṇḍyaḥ /	If, while he is occupying a seat, lying on a bed, speaking, or walking on the road, he seeks to be their equal, he should be beaten.
śataṃ kṣatriyo brāhmaṇākrośe /	If a Kşatriya hurls abusive words at a Brahmin, he shall be fined a hundred;* if there is physical violence, the fine is doubled. A Vaisya guilty of the same crime shall be fined one and a half times as much as a Kṣatriya.
brāhmaṇas tu kṣatriye pañcāśat /	A Brahmin guilty of the same crime against a Kṣatriya, on the other hand, shall be fined fifty, ¹ half that amount if it is against a Vaisya, ³ and none at all if it is against a Śūdra.
brāhmaṇarājanyavat kṣatriyavaiśyau /	If a Kṣatriya is guilty of the same crime against a Vaiśya, or a Vaiśya against a Kṣatriya, the fine shall be the same as that levied on a Brahmin vis-à-vis a Kṣatriya, and on a Kṣatriya vis-à-vis a Brahmin, respectively.
aṣṭāpādyaṃ steyakilbiṣaṃ śūdrasya / dviguṇottarāṇītareṣāṃ prativarṇam /	Theft When a Śūdra steals, he must be made to repay the loss eightfold, ¹ and the fine is progressively doubled for thieves belonging to each of the prior classes.
viduṣo 'tikrame daṇḍabhūyastvam /	If the felon is a learned man, he should be punished more severely.
phalaharitadhānyaśākādāne pañcakṛṣṇalam alpam /	For stealing small amounts of fruits, vegetables, or grain, the fine is five Kṛṣṇalas (G . n.).
pālasaṃyukte tu tasmin / pathi kṣetre 'nāvṛte pālakṣetrikayoḥ /	Property Damage The owner is at fault when his animals cause damage; º but if a herdsman was looking after them at the time, then it is the herdsman's fault. If the damage is done to an unfenced field by the side of a road, then the fault lies with both the herdsman and the owner of the field.
pañca māṣā gavi /	For damage . done by a cow, the fine is five Māṣas (G .
ṣaḍ uṣṭrakhare /	n.); by a camel or a donkey, six; by a horse or a buffalo, ten; by sheep or goats, two for each.
sarvavināśe śadaḥ /	If the whole field is destroyed, the fine is the value of the crop.
śiṣṭākaraṇe pratiṣiddhasevāyāṃ ca nityaṃcailapiṇḍād ūrdhvaṃ svaharaṇam /	If a man consistently neglects what is prescribed and does what is forbidden, his property, beyond what is necessary to clothe and feed himself, shall be confiscated.
go'gnyarthe tṛṇamedhān vīrudvanaspatīnāṃ capuṣpāṇi svavad ādadīta phalāni cāparivṛtānām /	One may gather grass for a cow, wood for the fire, and flowers from vines and trees as if they were his own, and, if they are not fenced in, also fruits.
kusīdavṛddhir dharmyā viṃśatiḥ pañcamāṣikī māsam /	Rates of Interest The legal (dharmya) rate of interest is five Māṣas a month for twenty.* According to some, this rate does not apply for longer than a year.
cirasthāne dvaiguṇyaṃ prayogasya /	If the loan remains outstanding for a longer period of time, the principal is doubled.* No interest accrues if the lender makes use of the borrower's collateral, or when the borrower is eager to settle the debt but is prevented from doing so.
cakrakālavṛddhiḥ / kāritākāyikāśikhādhibhogāś ca /	The types of interest are: cyclical rate, periodic rate, contractual rate, manual labour, daily rate, and use of the collateral.* ³ In the case of animal products, wool, farm produce, and beasts of burden, the interest shall not exceed five times the loan.
ajaḍāpaugaṇḍadhanaṃ daśavarṣabhuktaṃ paraiḥ saṃnidhaubhoktuḥ /	Ownership When others make use of the property of a person who is neither mentally incapacitated nor a minor before his very eyes for ten years, it belongs to the user, unless the user is a vedic scholar, a wandering ascetic, or a royal officer.
na śrotriyapravrajitarājapurṣaiḥ /	There is no such limit on the period of use in the case of cattle, land, and women.* Debts Those who inherit the property of someone have to pay his debts. Sons are not accountable for a surety's bond, a business debt, a bride price, debts relating to liquor or gambling, or fines.
nidhyanvādhiyācitāvakrītādhayo naṣṭāh sarvānaninditān puruṣāparādhena /	So long as a person has a blameless reputation, he is not accountable for an open or sealed deposit, something borrowed or purchased, or a collateral for a loan that is lost without his fault.
stenaḥ prakīrṇakeṣo musalī rājānam iyātkarmācakṣānaḥ /	Punishment A thief, his hair dishevelled and carrying a pestle, should go to the king proclaiming his deed.
pūto vadhamokṣābhyām /	He is cleansed by .
aghnann enasvī rājā /	being killed or released, but by not killing him the king assumes the sin.
na śārīro brāhmaṇadaṇḍaḥ / karmaviyogavikhyāpanavivāsanāṅkakaraṇāni /	Dharmasutras There shall be no corporal punishment of Brahmins; they are punished by extricating them from such deeds, publishing their crimes, sending them into exile, and branding them.
apravṛttau prāyaścittī saḥ /	If a king fails to punish, he should perform a penance.
pratigrahītāpy adharmasaṃyukte / puruṣaśaktyaparādhānubandhavijñānād daṇḍaniyogaḥ /	A man who knowingly becomes an associate of a thief shall be treated like a thief, as also a man who illicitly (adharma) receives goods from him. Punishment should be meted out after taking into account the type of a man he is, his strength, the gravity of the crime, and how often he has committed it. Alternatively, the man may be pardoned according to the verdict of an assembly of men learned in the Vedas.
vipratipattau sākṣinimittā satyavyavasthā /	Witnesses ¹If there is conflicting evidence, the truth shall be ascertained by means of witnesses.
bahavaḥ syur aninditāḥ svakarmasu prātyayikā rājñāṃniṣprītyanabhitāpāś cānyatarasmin /	They should be numerous, of blameless reputation with respect to their duties, worthy of the king's trust, and neither friendly nor hostile towards either party.
api śūdrāḥ /	They may even be Śūdras.
brāhmaṇas tv abrāhmaṇavacanād anavarodhyo 'nibaddhaścet /	Unless a Brahmin is listed in the plaint, however, he should not be forced to testify at the behest of a non-Brahmin.
avacane 'nyathāvacane ca doṣiṇaḥ(doṣa-) syuḥ /	Witnesses should not speak until they are convened and questioned; but if they then refuse to speak, they commit an offence.
svargaḥ satyavacane viparyaye narakaḥ /	If they speak the truth, they will go to heaven; if they do the contrary, hell awaits them.
anibaddhair api vaktavyam /	Even those not listed in the plaint may be obliged to give evidence. No objection can be raised against a witness in cases involving violence ¹ or for things he may have said inadvertently.
sākṣisabhyarājakartṛṣu doṣo dharmatantrapīḍāyām /	If the execution of the Law* is thwarted, the guilt falls on the witnesses, the assessors, the king, and the transgressor.
taddevarājabrāhmaṇasaṃsadi syād abrāhmaṇānām /	According to some, the witnesses are to be placed under oath to speak the truth; ¹³ if they are not Brahmins, the oath should be administered in the presence of divine images, the king, and Brahmins.
kṣudrapaśvanṛte sākṣī daśa hanti / gośvapuruṣabhūmiṣu daśaguṇottarān /	If a witness gives false testimony with regard to small farm animals, he slays* ten; with regard to cattle, ten times as many; with regard to horses, ten times as many as for cattle; with regard to human beings, ten times as many as for horses.
sarvaṃ vā bhūmau / haraṇe narakaḥ /	If he . gives false testimony with regard to land, he slays all; and if he steals land, he goes to hell.
bhūmivad apsu / maithunasaṃyoge ca / paśuvan madhusarpiṣoḥ / govad vastrahiraṇyadhānyabrahmasu /	The penalty for false testimony with regard to land applies also to water ¹ and sexual intercourse; the penalty in the case of farm animals applies also to honey and ghee; ¹ the penalty in the case of cattle applies also to clothes, gold, grain, and the Veda; and the penalty in the case of horses applies also to carriages.
mithyāvacane yāpyo daṇḍyaś ca sākṣī /	When a witness gives false testimony, he should be reprimanded and punished.
na tu pāpīyaso jīvanam /	It is not an offence to give false testimony if a man's life depends on it, but not if it is the life of an evil man.
rājā prāḍvivāko brāhmaṇo vā śāstravit /	The king shall be the judge, or else a learned Brahmin. Witnesses should appear before the judge.
prāḍvivākam adhyābhavet /	If they are unable to appear, the judge may wait for one year.
dhenvanaḍutstrīprajananasaṃyuṃkte caśīghram / ātyayike ca /	But in cases affecting cows, draught oxen, women, and begetting children, he should summon them immediately, as also when the matter is urgent.
sarvadharmebhyo garīyaḥ prāḍvivāke satyavacanaṃsatyavacanam /	Of all the Laws, speaking the truth before the judge is the most important.
ekādaśarātraṃ kṣatriyasya /	IMPURITY Death Impurity ¹A ten-day period of death impurity affects people belonging to the same ancestry (A ..
dvādaśarātraṃ vaiśyasya /	In the case of Kṣatriyas, the period of impurity lasts for eleven days; ³in the case of Vaisyas for twelve days-or, according to some, for a fortnight-; and in the case of Sudras for a month.
tac ced antaḥ punar āpatec cheṣeṇa śudhyeran / rātriśeṣe dvābhyām / prabhāte tisṛbhiḥ /	If during that period another period of impurity arises, they become pure at the end of the time remaining from the first period of impurity; but if only one day remains, then at the end of two days; and if it happens on the morning after the conclusion of the first period, then at the end of three days.
gobrāhmaṇahatānām anvakṣam / rājakrodhāc ca /	When people are killed while defending cows or Brahmins,* their relatives become pure immediately; ¹ as also when they are killed due to the king's anger ¹¹or in a battle; ¹ and when they .
prāyānāśakaśastrāgniviṣodakodbandhanaprapatanaiś cecchatām /	die voluntarily by walking without food or drink, by fasting, by a sword, in a fire, by poison, by drowning, by hanging, and by jumping from a precipice.
piṇḍanivṛttiḥ saptame pañcame vā /	Relationship caused by ancestry (A .. n.) ceases with the fifth or seventh generation.
janane 'py evam / mātāpitros(pitṛ) tat /	Dharmasūtras These same rules of impurity come into effect also at the birth of a child; ¹ they apply to the parents or just to the mother.
tryahaṃ vā /	When there is a miscarriage, the period of impurity lasts for as many days as the months since conception, ¹ or else for three days.
śrutvā cordhvaṃ daśamyāḥ pakṣiṇīm /	If someone hears of a relative's death after ten or more days, the period of impurity lasts two days plus the intervening night, as also at the death of a maternal relative not belonging to his ancestry or of a fellow reciter of the Veda.
asapiṇḍe yonisaṃbandhe sahādhyāyini ca /	For a fellow student,* the period of impurity lasts for a day, as also for a vedic scholar who lives close by.
pretopasparśane daśarātram āśaucam abhisaṃdhāya cet /	Contact with a Corpse When someone comes into contact with a corpse, the period of impurity lasts for ten days if it is done for a consideration.
uktaṃ vaiśyaśūdrayoḥ /	The period of impurity for such contact in the case of Vaisyas and Śūdras is the same as that given above, or for as many days as there are seasons* in a year.
tryahaṃ vā / ācāryatatputrastrīyājyaśiṣyeṣu caivam /	The latter rule is applicable also to the two higher classes; or else their impurity lasts for three days, as also when someone comes in contact with the corpse of his teacher, the teacher's son or wife, a man for whom he performs priestly functions, or his pupil.
avaraś ced varṇaḥ pūrvavarṇam upaspṛśet pūrvovāvaraṃ tatra śavoktam āśaucam /	If a person of a lower class comes in contact with the corpse of a higher class person, or a person of a higher class with the corpse of a lower class person, then the period of impurity is what is prescribed for the class to which the dead man belonged (G .-).
patitacaṇḍālasūtikodakyāśavaspṛṣṭitatspṛṣṭyupasparśanesacailodakopasparśanāc chudhyet / śavānugamane ca / śunaś ca /	Contact with Impure Persons When a man touches an outcaste, a Cāṇḍāla, a woman who has just given birth or is menstruating, a corpse, or someone who has touched any of these, he becomes purified by bathing with his clothes on; as also when he has gone behind a corpse or touched a dog.
yad upahanyād ity eke /	According to some, the spot touched by the dog should be washed.
udakadānaṃ sapiṇḍaiḥ kṛtacūḍasya /	Libations to the Deceased Those who belong to the same ancestry should offer water to a deceased person whose tonsure ceremony (G .
eke prattānām /	n.) has been performed and for the wives of such a person; ³ according to some, also for their married relatives.
na mārjayīran / na māṃsaṃ bhakṣayeyur ā pradānāt / prathamatṛtīyasaptamanavameṣūdakakriyā / vāsasāṃ ca tyāgaḥ /	All should sleep and sit on the floor; remain chaste; ³ not wash themselves; not eat meat until the funeral oblation has been offered; º offer libations of water on the first, third, fifth, seventh, and ninth day after the death; ¹ discard the garments worn during these rites; but on the last day give them to people of the lowest class.
dantajanmādi mātāpitṛbhyām /	Parents must offer these libations to a child who has teethed.
bāladeśāntaritapravrajitāsapiṇḍānāṃ sadyaḥ śaucam / rājñāṃ ca kāryavirodhāt / brāhmaṇasya ca svādhyāyanivṛttyarthamsvādhyāyanivṛttyartham /	Immediate Purification When infants, people who have gone to a distant region, wandering ascetics, and people who do not belong to the same ancestry die, a person is purified immediately; as also kings, lest their duties be impeded; and a Brahmin, so as not to interrupt his daily vedic recitation.
amāvāsyāyāṃ pitṛbhyo dadyāt /	ANCESTRAL OFFERINGS ¹ Next, the ancestral offerings. One should offer them to one's ancestors on the new-moon day, ³ or else after the fourth day of the fortnight of the waning moon or on any day of that fortnight according to one's faith.
dravyadeśabrāhmaṇasaṃnidhāne vā kālaniyamaḥ /	If materials, location, or Brahmins of special significance are at hand, however, one does not have to observe any restriction with regard to time.
śaktitaḥ prakarṣed guṇasaṃskāravidhir annasya / navāvarān bhojayed ayujaḥ /	Dharmasutras Quality of Invitees "One should obtain the best possible food, get it prepared to the best of one's ability, and feed an uneven number of Brahmins but at least nine or as many as he can affordBrahmins who are vedic scholars, gifted with eloquence and beauty, mature in years, and virtuous.
eke pitṛvat /	It is best to feed people who are young; according to some, they should be of the same age as the deceased ancestor.
na ca tena mitrakarma kuryāt /	One should not use this rite to strike a friendship.
putrābhāve sapiṇḍā mātṛsapiṇḍāḥ śiṣyāś ca dadyuḥ / tadabhāva ṛtvigācāryau /	In the absence of a son, those belonging to the same ancestry, those belonging to the same ancestry as his mother, or his pupils should make the ancestral offering; ¹ and if even these are unavailable, his officiating priest or teacher.
tilamāṣavrīhiyavodakadānair māsaṃ pitaraḥprīṇanti / na bhojayet stenaklībapatitanāstikatadvṛttivīrahāgredidhiṣupatistrīgrāmayājakājāpālotsṛṣṭāgnimadyapakucarakūṭasākṣiprātihārikān	Types of Food By offering sesame, beans, rice, barley, and water, the ancestors are satisfied for a month; by offering fish or the meat of antelope, Ruru antelope, rabbit, turtle, boar, or sheep, for several years; by offering cow's milk or milk pudding, for twelve years; by offering the meat of a Vārdhrīṇasa crane, sacred basil, or the meat of a goat, a red goat, or a rhinoceros, mixed with honey, for an unlimited time.* Unfit Invitees He should not feed the following: a thief; a man who is impotent; an outcaste; an infidel or a man who lives like an infidel; someone who has relinquished his sacred fires; someone who has married a younger sister with an unmarried older sister or an older sister whose younger sister is already married; someone who officiates at the sacrifices of women or a group of men; a goat herder; someone who has given up fire sacrifices, drinks liquor, or behaves improperly; a false witness; a door-keeper; the lover of a married woman and that woman's husband; someone who eats the food of a man born from an adulterous union or sells Soma; an arsonist; a poisoner; a man who has .
upapatiḥ /	broken his vow of chastity as a student; someone who is in the service of a guild; someone who has sex with a forbidden woman; a sadist; a man whose younger brother gets married before him or who gets married before his older brother; someone whose younger brother has set up the ritual fires before him or who has set up the ritual fires before his older brother; someone who is suicidal; a man who is bald-headed or has bad nails, black teeth, or white leprosy; the son of a remarried woman; a gambler; someone who does not engage in the soft recitation of prayers (A ..
pitrā(pitṛ) śiṣyāṃś caike sagotrāṃś ca /	n); a servant of the king; someone who cheats by using false weights and measures; the husband of a Śūdra woman;* someone who neglects his private vedic recitation; a man with spotted leprosy; a usurer; someone who lives as a merchant or artisan; someone who is fond of archery, playing music, keeping the beat at performances, dancing, and singing; and those who have divided the paternal estate against their father's wishes.
bhojayed ūrdhvaṃ tribhyaḥ /	According to some, he may invite his pupils and people belonging to his ancestry. He should feed more than three persons, or a single distinguished person.
sadyaḥ śrāddhī śūdrātalpagas tatpurīṣe māsaṃnayati pitṛṛn /	Sexual Abstinence If someone has sex with a Śūdra woman soon after eating at an ancestral offering, he will plunge his ancestors in her excrement for a whole month.
tasmāt tadaham brahmacārī ca syāt /	That whole day, therefore, he should remain chaste.
śvacāṇḍālapatitāvekṣaṇe duṣṭam /	Pollution and Remedies An ancestral offering is ruined if it is seen by a dog, a Cāṇḍāla, or an outcaste.
tasmāt pariśrite dadyāt /	Therefore, he should offer it in an enclosed place; alternatively he should scatter sesame seeds over the offering, or a man who purifies those alongside whom he eats (A ..
tilair vā vikiret /	n.) may remove the defilement.
paṅktipāvanaḥ ṣaḍaṅgavij jyeṣṭhasāmikas triṇāciketastrimadhus trisuparṇaḥ pañcāgniḥ snātako mantrabrāhmaṇavid #	These are the persons who purify those alongside whom they eat: a man who knows the six Vedic Supplements (A ..-); a man who sings the Jyeștha Sāmans; an expert in the three Nāciketa fire . altars; a man who knows the three 'Honey' verses; a man who knows the Trisuparna; a man who maintains the five sacred fires (A .. n.); a bath-graduate; a man who knows the vedic Hymns and Brāhmaṇa texts; a man who knows the Law; and a descendant from a line of vedic scholars.
haviḥṣu caivam /	Dharmasutras The above rules apply also to sacrificial offerings.
ardhapañcamān māsān pañca dakṣiṇāyanaṃ vā /	According to some, however, the prohibition of a bald man and those listed after him applies only to ancestral offerings. ANNUAL COURSE OF STUDY ¹After commencing the annual course of study on the full-moon day of July-August or August September, he should study the Vedas for four and a half months, or five months, or else during the time the sun moves south.
brahmacāry utsṛṣṭalomā na māṃsaṃ bhuñjīta /	During this period he should remain chaste, refrain from shaving, and abstain from meat.
dvaimāsyo vā niyamaḥ /	Optionally, these rules may be observed for just two months.
nādhīyīta vāyau divā pāṃsuhare / karṇaśrāviṇi naktam / vāṇabherīmṛdaṅgagartārtaśabdeṣu / śvaśṛgālagardabhasaṃhrāde / rohitendradhanurnīhāreṣu /	Suspension of Vedic Recitation $He should suspend vedic recitation during daytime when the wind whirls up the dust; at night when he can hear the wind blow; when the sound of a lute, drum, side drum, chariot, or wailing is heard; when dogs are barking, jackals are howling, and donkeys are braying; when the sky turns crimson; when a rainbow appears; when there is frost on the ground; when clouds appear out of season; when he has the urge to void urine or excrement; ¹ in the middle of the night, at the time of twilight, and while standing in water; ¹ when it is raining but, according to some, only when the water is running down the eaves-; ¹ when Venus and Jupiter are surrounded by halos, as also the sun and the moon; when he is frightened, travelling in a vehicle, lying down, or has lifted his feet; when he is in a cremation ground, at the village boundary, on a highway, or in an impure state; when there is a foul smell; when there is a corpse or a Cāṇḍāla in the village; when a Śūdra is near by; and when he experiences an acrid belching.
bhuktake codgāre / ṛgyajuṣaṃ ca sāmaśabdo yāvat /	The recitation of the Rgveda and the Yajurveda, moreover, is suspended as long as the recitation of the Samaveda is heard.* When there is a lightning strike, an earthquake, an eclipse, or the fall of a meteor, vedic recitation is suspended until the same time the next day; as also when there is thunder, rain, or lightning during twilight when the fires are visible.
ākālikā nirghātabhūmikamparāhudarśanolkāḥ /	When these happen during the rainy season, however, the suspension lasts only that day.
vidyuti naktaṃ cāpararātrāt /	When there is lightning during the night, moreover, the suspension lasts until the last watch of the night (B ..
tribhāgādipravṛttau sarvam /	n.); but if it occurs during or after the third part of the day, the suspension lasts the whole night.
ulkā vidyutsamety ekeṣām /	According to some, a meteor has the same effect as lightning with respect to the suspension of vedic recitation, recitation, as does thunder when it occurs in the afternoon or even at dusk.
stanayitnur aparāhṇe / api pradoṣe / sarvaṃ naktam ārdharātrāt /	If there is thunder before midnight, the suspension lasts for the whole night; ³¹ if it happens during the day, the suspension lasts throughout the daylight hours, as also when the king of that realm dies, ³³ and when one student goes on a journey and another stays behind with the teacher (cf.
ahaś cet sajyotiḥ /	A ..).
viproṣya cānyonyena saha / saṃkulopāhitavedasamāpticchardiśrāddhamanuṣyayajñabhojaneṣvahorātram /	The suspension lasts for a day and a night when there has been a social disturbance or a fire; when he has finished reciting one Veda; when he has vomited; when he has eaten at an ancestral offering or at a sacrifice to humans (A ..
amāvāsyāyāṃ ca / dvyahaṃ vā /	n.); on the new-moon day-³ alternatively, the suspension here may last for two days-; and on the full-moon days of the lunar months October-November, February-March, and June-July.
tisro 'ṣṭakās trirātram / antyām eke /	At the three eighth-day offerings during the three fortnights of the waning moon following the full moon of NovemberDecember, the suspension lasts for three days; according to some, the suspension takes place only at the last of these eighthday offerings.
abhito vārṣikam / sarve varṣāvidyutstanayitnusaṃnipāte / prasyandini / ūrdhvaṃ bhojanād utsave /	In the opinion of all authorities, when rain, lightning, and thunder occur together, the suspension lasts for three days, as also when there is heavy rain. On a festive day vedic recitation is suspended after the meal.
prādhītasya ca niśāyāṃ caturmuhūrtam /	Immediately after commencing the annual course of study, . recitation is suspended during the first four hours' (A ..
nityam eke nagare /	n.) of the night. According to some, vedic recitation is always suspended in a town.
mānasam apy aśuciḥ /	Even mental recitation is suspended when a person is impure.
śrāddhinām(śrāddha) ākālikam / akṛtānnaśrāddhikasaṃyoge 'pi /	After making an ancestral offering, the suspension lasts until the same time the next day, as also when uncooked food is distributed at an ancestral offering.
praśastānāṃ svakarmasu dvijātīnāṃ brāhmaṇo bhuñjīta /	Dharmasutras Vedic recitation is also suspended for reasons given in each vedic branch (p. xxii). FOOD Food Transactions ¹A Brahmin may eat food given by twice-born men renowned for their devotion to their respective duties.
pratigṛhṇīyāc ca /	He may also accept gifts from them.
pitṛdevagurubhṛtyabharaṇe 'py anyat /	Firewood, water, fodder, roots, fruits, honey, a promise of safety, what is given unasked, beds, seats, shelter, carriages, milk, curd, roasted grain, Śapharī fish, millet, garlands, venison, and vegetables should not be refused from anyone, as also other things needed to take care of the ancestors, gods, teacher, and dependants.
vṛttiś cen nāntareṇa śūdrāt /	If he is unable to sustain himself by other means, he may accept food from a Sūdra.
paśupālakṣetrakarṣakakulasaṃgatakārayitṛparicārakāḥbhojyānnāḥ / vaṇik cāśilpī /	A man who looks after his animals or ploughs his fields, a friend of the family, his barber, and his personal servant-these are people whose food he may eat, as also a merchant who is not an artisan.
nityam abhojyam /	This type of food is not fit to be eaten every day.
bhrūṇaghnāvekṣitam / bhāvaduṣṭam / gavopaghrātam / śuktaṃ kevalam adadhi /	Unfit Food 'The following are unfit to be eaten: food into which hair or an insect has fallen; ¹ what has been touched by a menstruating woman, a black bird, or someone's foot; ¹¹ what has been looked at by an abortionist (A .. n.) ¹ or smelt by a cow; ¹ food that looks revolting;* ¹ food that has turned sour, except curd; re-cooked food; ¹food that has become stale, except vegetables, chewy or greasy foods, meat, and honey; ¹ food given by .
anarcitaṃ ca /	someone who has been disowned by his parents, a harlot, a heinous sinner (A ..
goś ca kṣīram anirdaśāyāḥ sūtake / ajāmahiṣyoś ca / nityam āvikam apeyam auṣṭram aikaśaphaṃ ca / syandinīyamasūsaṃdhinīnāṃ ca /	n.), a hermaphrodite, a law enforcement agent, a carpenter, a miser, a jailer, a physician, a man who hunts without using the bow or eats the leftovers of others, a group of people, or an enemy, as also by those listed before a bald man as people who defile those alongside whom they eat (G .-; A .. n.); ¹food prepared for no avail; a meal during which people sip water or get up against the rules, or at which different sorts of homage are paid to people of equal stature and the same homage is paid to people of different stature; ¹ and food that is given disrespectfully.
pañcanakhāś cāśalyakaśaśaśvāvidgodhākhaḍgakacchapāḥ /	Forbidden Food - It is forbidden to drink the milk of a cow, a goat, or a buffalo, during the first ten days after it gives birth; the milk of sheep, camels, and one-hoofed animals under any circumstances; the milk of an animal from whose udders milk flows spontaneously or of an animal that has borne twins, gives milk while pregnant, or has lost her calf. The following are forbidden foods: animals with five claws (A ..
ubhayatodatkeśyalomaikaśaphakalaviṅkaplavacakravākahaṃsāḥ / kākakaṅkagṛdhraśyenā jalajā raktapādatuṇḍāgrāmyakukkuṭasūkarāḥ / dhenvanaḍuhau ca /	n.), with the exception of the hedgehog, hare, porcupine, Godhā monitor lizard, rhinoceros, and tortoise; animals with teeth in both jaws,* with a lot of hair, or without any hair; one-hoofed animals; Kalavinka sparrows; Plava herons; Cakravāka geese; Hamsa geese; crows; Kanka herons; vultures; falcons; water birds; red-footed and red-beaked birds; village cocks and pigs; milch-cows and oxen; ³¹ meat of animals whose milk-teeth have not fallen and of animals that are sick or wantonly killed; young shoots; mushrooms; garlic; resins; red juices* flowing from incisions on trees; woodpeckers; Baka egrets; Balāka ibis; parrots; Madgu cormorants; Țiṭṭibha sandpipers; Māndhala flying foxes; and night birds. Birds that feed by thrusting their beaks or scratching with their feet and that do not have webbed feet may be eaten, as also fish that are not grotesque, ³ and animals that have to be killed for the sake of the Law.* He may avail himself of animals killed by predators after washing them, so long as he does .
apannadannavasannavṛthāmāṃsāni /	not detect any flaw in them and after getting them verbally declared as suitable.
asvatantrā dharme strī /	Dharmasutras WOMEN AND MARRIAGE Duties of a Wife ¹A wife cannot act independently in matters relating to the Law.
nāticared bhartāram(bhartṛ) / vākcakṣuḥkarmasaṃyatā /	She should never go against her husband ³ and keep her speech, eyes, and actions under strict control.
guruprasūtā nartum(ṛtu) atīyāt /	Levirate When her husband is dead, she may seek to obtain offspring through her husband's brother after she has been appointed to the task by the elders (A ..
nātidvitīyam /	n.). She should not have sex with him outside her season (A ..n.).
janayitur apatyam /	Alternatively, she may obtain offspring through a relative* belonging to the same ancestry, lineage, or line of seers (A .. n.; A ..
samayād anyasya /	n.), or just a relative; according to some, however, through no one other than her husband's brother.
jīvataś ca kṣetre /	To Whom Belongs a Son 'The offspring belongs to the man who fathers it, unless there has been a compact (G .) ¹¹ or it has been fathered on a wife whose husband is still alive.
parasmāt tasya / dvayor vā /	If it is fathered by an outsider, however, the offspring belongs to that outsider, ¹ or to both; ¹ but if the husband cares for that offspring, then it belongs to him alone (A .. n.).
rakṣaṇāt tu bhartur(bhartṛ) eva /	Remarriage of a Wife ¹ If her husband is missing, she shall wait for six years.
śrūyamāṇe 'bhigamanam /	If he is heard from, she shall go to him.
pravrajite tu nivṛttiḥ prasaṅgāt /	If her husband has become an ascetic, on the other hand, she shall give up all attachments.
dvādaśa varṣāṇi brāhmaṇasya vidyāsaṃbandhe /	When a Brahmin has gone away to study the Veda, his wife should wait for twelve years.
bhrātari(bhrātṛ) ṣaḍ ity eke /	Marriage of a Younger Brother ¹ Likewise, when an older brother is missing, a younger brother of his should wait for the same length of time before getting married or establishing the sacred fires; ¹ for six years, according to some.
trīn kumāry ṛtūn atītya svayaṃyujyetāninditenotsṛjya pitryān alaṃkārān /	Time of Marriage for Girls When three menstrual periods have passed, a girl may discard the jewellery her father has given her and join herself on her own to a man of blameless reputation.
aprayacchan doṣī /	A girl shall be given in marriage before she reaches puberty, and a man who fails to give her incurs a sin.
prāg vāsasaḥ pratipatter ity eke /	According to some, she should be given in marriage before she begins to wear clothes.* . LEGITIMATE SEIZURE OF PROPERTY To perform a marriage or in connection with the course of the Law (G .
anyatrāpi śūdrād bahupaśor hīnakarmaṇaḥ / śatagor anāhitāgneḥ / sahasragoś cāsomapāt /	n.), a person may take money from a Śūdra, or even from a non-Śūdra who has plenty of livestock but neglects his rituals, who owns a hundred cows but has not set up the sacred fires, or who owns a thousand cows but has not offered a Soma sacrifice.
saptamīṃ cābhuktvāanicayāya /	A man may do so also when he has had nothing to eat until the seventh mealtime (A ..
apy ahīnakarmabhyaḥ /	n.), but not to hoard, taking even from people who do not neglect their rituals.
ācakṣīta rājñā pṛṣṭaḥ / tena hi bhartavyaḥ śrutaśīlasaṃpannaś cet /	If the king interrogates him, he should confess, for if he is learned and virtuous, the king is required to support him.
dharmatantrapīḍāyām tasyākaraṇe doṣo /	If the king does not act when the course of the Law (G . n.) is in jeopardy, he is at fault.
ukto varṇadharmaś cāśramadharmaś ca /	PENANCES We* have explained the Law pertaining to the social classes and the Law pertaining to the orders of life.
atha khalv ayaṃ puruṣo yāpyena karmaṇā lipyate yathaitad ayājyayājanam abhakṣyabhakṣaṇam avadyavadanaṃśiṣṭasyākriyā #	Justification of Penance Now, a man here is tainted by foul actions, as, for example, by officiating at sacrifices of people for whom it is forbidden to officiate, by eating what is forbidden to eat, by saying what is forbidden to say, by failing to do what is enjoined, and by indulging what is forbidden.
tatra prāyaścittaṃ kuryāt na kuryād iti mīmāṃsante /	There is a debate as to whether such a man is required to perform a penance or not.
na hi karma kṣīyata iti /	Some say that he is not required to do so, arguing that an act can never be wiped out.
kuryād ity aparam /	The other, and correct, view is that he is required to do so, as it is stated, ‘After offering the .
tarati sarvaṃ pāpmānaṃ tarati brahmahatyāṃyo,	Dharmasutras Punastoma sacrifice, he gets to participate again in the Soma sacrifice', ³ or after offering the Vrātyastoma. Likewise, ‘A man who offers a horse sacrifice overcomes all sins, he overcomes even the murder of a Brahmin' (SB ...); and, 'A heinous sinner (A ..
agniṣṭutābhiśasyamānaṃ yājayed iti ca /	n.) should be made to offer the Agnișțut sacrifice.' General Penances The expiations for such a man are softly reciting prayers (A ..n.), austerity, ritual offering, fasting, and giving gifts.
upaniṣado vedāntaḥ sarvacchandaḥsu saṃhitā madhūnyaghamarṣaṇam	Upanişads; the conclusions of the Vedas (vedānta); the HymnCollections of all the Vedas; the 'Honey' verses; Aghamarṣaṇa hymn; Atharvaśiras; Rudra hymn; Purușa hymn; the Sāmans called Rājana, Rauhini, Brhat, Rathantara, Puruşagati, Mahānāmnī, Mahāvairāja, and Mahādivākīrtya; any of the Jyeṣṭha Sāmans; Bahiṣpavamāna Sāman; Kūṣmāṇḍa verses; Pāvamānī verses; and the Savitrī verse-these are the purificatory texts.
payovratatā śākabhakṣatā phalabhakṣatāprasṛtayāvako hiraṇyaprāśanaṃ ghṛtaprāśanaṃ somapānam itimedhyāni /	Living on milk alone; eating only vegetables; eating only fruits; living on gruel made with one handful of barley; eating gold; consuming ghee; and drinking Soma juicethese are the cleansing activities.
sarve śiloccayāḥ sarvāḥ sravantyaḥ puṇyā hradāstīrthāny ṛṣinivāsā goṣṭhapariskandhā iti deśāḥ /	All mountains; all rivers; sacred lakes; sacred fords; dwellings of seers; cow-pens; and temples-these are the appropriate places.
brahmacaryaṃ satyavacanaṃ savaneṣūdakopasparśanamārdravastratādhaḥśāyitānāśaka iti tapāṃsi(tapas) /	Observing chastity; speaking the truth; bathing at dawn, noon, and dusk; remaining in wet clothes after the bath; sleeping on the floor; and fastingthese are the austerities.
hiraṇyaṃ gaur vāso 'śvo bhūmis tilā ghṛtam annam itideyānīti /	Gold; cow; garment; horse; land; sesame seeds; ghee; and food-these are the gifts.
saṃvatsaraḥ ṣaṇmāsāś catvāras trayo vā dvauvaikaś caturviṃśatyaho dvādaśāhaḥ ṣaḍahas tryaho 'horātra itikālāḥ	One year; six months; four months; three months; two months; one month; twenty-four days; twelve days; six days; three days; and a day and night these are the lengths of time.
etāny evānādeśe vikalpena kriyeran /	When no specific penance has been prescribed, people may perform these optionally, the heavier penances for grave sins and the lighter penances for minor sins.
kṛcchrātikṛcchrau cāndrāyaṇam iti sarvaprāyaścittaṃ /	The arduous penance (B ..), the very arduous penance (B ..), and the lunar penance (G ; B .) are expiations for all types of sins.
tyajet pitaraṃ(pitṛ)	Excommunication from Caste ¹A man should disown a father who assassinates a king; sacrifices for a Śūdra; uses a Sūdra's money for a sacri fice; divulges the Vedas; is an abortionist (A ..
pātraṃ cāsya viparyasyeyuḥ /	n.); lives with very low caste men; or cohabits with a woman of a very low caste.
dāsaḥ karmakaro vāvakarād amedhyapātram ānīyadāsīghaṭāt pūrayitvā dakṣiṇāmukho yadā viparyasyed amukam anudakaṃkaromi #	Assembling the father's vedic teachers and blood relations, they should perform on his behalf all the funerary rites, beginning with the offering of water, ³ and overturn his water pot. A slave or a workman should bring a dirty pot from a garbage dump, fill it with water from a slave woman's pot, and, facing the south, overturn it with his foot, pronouncing the man's name and saying, 'I deprive that man of water'.
taṃ sarve 'nvālabheran prācīnāvītino muktaśikhāḥ /	All of them, their upper garments slung over their right shoulders and under their left arms (A ..
vidyāguravo(guru)	n.) and their topknots untied, should touch that slave, while the vedic teachers and blood relations look on.
apa upaspṛśya grāmaṃ praviśanti /	They should then bathe and enter the village.
ata uttaraṃ tena saṃbhāṣya tiṣṭhed ekarātraṃ japansāvitrīm ajñānapūrvam / jñānapūrvaṃ ca trirātram /	Contact with an Outcaste Thereafter, if someone were to speak with that man, he should remain standing reciting the Savitrī verse for one night if it was done unintentionally, and for three nights if it was done intentionally.
yas tu prāyaścittena śudhyet tasmiñ śuddheśātakumbhamayaṃ pātraṃ puṇyatamād dhradāt pūrayitvā sravantībhyovā #	Readmission into Caste An excommunicated man may be purified by performing a penance, however, and when he has been so purified, they should fill a golden pot with water from a very sacred lake or from a river and make the man take a bath with the water from that pot.
athāsmai tatpātram dadyus tatapratigṛhya japecśāntā dyauḥ śāntā pṛthivī śāntaṃ śivam antarikṣaṃ yo rocanastābhamam #	They should then give that pot to him. Taking that pot, he should pray silently: 'The sky is appeased, the mid-space is appeased and auspicious, the earth is appeased.
etair yajurbhiḥ pāvamānībhis taratsamandībhiḥkūṣmāṇḍaiś cājyaṃ juhuyād /	I here take hold of the radiant one.' ¹ Reciting these Yajus formulas, as well as the Pāvamānī, Taratsamandī, and Kūṣmāṇḍa verses, he should offer ghee in the sacred fire.
hiraṇyaṃ brāhmaṇāyadadyāt / gāṃ vā / ācāryāya ca /	He should then give gold or a cow to a Brahmin, as well as to his teacher.
yasya tu prāṇāntikaṃ prāyaścittaṃ sa mṛtaḥśudhyet /	A man whose penance lasts until death (cf. G .-), on the other hand, becomes pure only after he dies.
sarvāṇy eva tasminn udakādīni pretakarmāṇi kuryuḥ /	They should perform for him all the funerary rites beginning with the offering of water. The same rite of bathing with water consecrated by the 'appeasement' formulas given above is to be performed for all secondary sins causing loss of caste.
brahmahasurāpagurutalpagamātṛpitṛyonisaṃbandhāgastenanāstikaninditakarmābhyāsipatitātyāgyapatitatyāginaḥ patitāḥ pātakasaṃyojakāś ca /	Dharmasutras Sins Causing Loss of Caste Grievous Sins ¹People who murder a Brahmin; drink liquor; have sex with the wife of an elder (A .. n.) or with a woman who is related through his mother or father, or through marriage; steal gold; become infidels; habitually commit forbidden acts; refuse to disown someone fallen from his caste; or disown someone who has not fallen from his castethese have fallen from their caste, as also those who instigate sins causing loss of caste, and those who associate with outcastes for a year.
dvijātikarmabhyo hāniḥ patanam /	Consequences of Falling from Caste Falling from one's caste entails exclusion from the occupations of twice-born people and going empty-handed into the next world.
tam eke narakam /	Some call this condition 'hell'.
trīṇi prathamāny anirdeśyāny anu /	Expiations According to Manu, no expiation is possible for the first three sins.
na strīṣv agurutalpaṃ patatīty eke /	Some maintain that a man does not fall from his caste by having sex with women other than the wives of his elders (A ..
bhrūṇahani hīnavarṇasevāyāṃ ca strīpatati /	Fall of Women A woman falls from her caste by carrying out an abortion and by having sex with a low-caste man.
kauṭasākṣyaṃ rājagāmi paiśunam guroranṛtābhiśaṃsanaṃ mahāpātakasamāni / apaṅktyānāṃ prāgdurbālādgohantṛbrahmaghnatanmātrakṛdavakīrṇipatitasāvitrīkeṣūpapātakam /	Sins Similar to Grievous Sins Giving false evidence, slanderous statements that will reach the king's ear, and false accusations against an elder (A .. n.) are equal to sins causing loss of caste. Secondary Sins ¹People who defile those alongside whom they eat and listed before a bald man (G .-; A ..
ajñānād andhyāpanād ṛtvigācāryaupatanīyasevāyāṃ ca heyau /	n.); people who kill cows, forget the Veda, or recite sacred formulas for such people; students who break their vow of chastity; and those who let the time for their initiation lapse (G .-)— these are guilty of secondary sins causing loss of caste. ¹ One should disown an officiating priest or a teacher who is ignorant or does not teach, or who commits a sin causing loss of caste.
anyatra hānāt patati / tasya ca pratigrahītety eke /	If anyone disowns them for other reasons, he falls from his caste, ¹ as also, according to some, all those who receive him.
brāhmanābhiśaṃsane doṣas tāvān / dvir anenasi /	A man shall never deprive his father or mother of susten but he should not accept any share of their estate.* Other Sins When someone accuses a Brahmin of a sin, he incurs a sin equal to it; twice as large if the man he accuses is innocent.
durbalahiṃsāyāṃ ca vimocane śaktaś cet /	When someone is hurting a weaker man, if a person, although he is able, does not rescue him, that person incurs a sin equal to that of the man causing the hurt.
abhikruddhāvagoraṇaṃ brāhmaṇasya varṣaśatamasvargyam / nighāte sahasram /	A man will be excluded from heaven for a hundred years if he threatens a Brahmin in anger; ¹ for a thousand years, if he strikes; ² and, if he draws blood, for as many years as the number of dust particles that the spilled blood lumps together.
prāyaścittam /	Description of Penances ¹ Next, the penances.
agnau saktir brahmaghnas trir avacchātasya /	Killing Humans and Animals A man who has killed a Brahmin shall emaciate his body and throw himself into a fire three times,* ³ or make himself a target during an armed battle.
khaṭvāṅgakapālapāṇir vā dvādaśa saṃvatsarānbrahmacārī bhaikṣāya grāmaṃ praviśet karmācakṣāṇaḥ /	Or else, for twelve years he should live a chaste life and, carrying a skull and the post from a bed-frame, enter a village only to beg for food while proclaiming his crime.
patho 'pakrāmet saṃdarśanād āryasya /	When he sees an Ārya, he should get out of the road.
sthānāsanābhyāṃ viharan savaneṣūdakopasparśīśudhyet /	In this manner he becomes purified, as he remains standing during the day and seated at night, and bathes at dawn, noon, and dusk.
prāṇalābhe vā tannimitte brāhmaṇasya / dravyāpacaye tryavaraṃ pratirāddhaḥ /	He is purified also if he saves a Brahmin's life; if he is defeated three times while attempting to recover the property stolen from a Brahmin; or if he takes part in the ritual bath at the end of a horse sacrifice or even of another sacrifice as long as it concludes with the Agnișțut offering. The same penance applies to a man who makes an attempt on the life of a Brahmin, even if he does not kill him, ¹ as also to one who kills a Brahmin woman soon after her .
aśvamedhāvabhṛthe vā /	menstrual period ¹ or a Brahmin's foetus whose sex cannot be determined (A ..– n.).
śūdre saṃvatsaram ṛṣabhaikādaśāś ca gā dadyāt /	If someone kills a Kşatriya, he should observe the standard vow of chastity for six years and give a thousand cows together with a bull (A .. n.); ¹ if he kills a Vaisya, he should do so for three years and give a hundred cows together with a bull; ¹ and if he kills a Śūdra, he should do so for one year and give ten cows together with a bull, ¹ as also when he kills a Brahmin woman who is not in her season.
gāṃ ca vaiśyavat / maṇḍūkanakulakākabimbadaharamūṣakaśvahiṃsāsuca / asthanvatām sahasraṃ hatvā /	Dharmasutras The penance for killing a cow is the same as for killing a Vaisya; ¹it is the same also for killing a frog, a mongoose, a crow, a chameleon, a rat, a mouse, or a dog, and for killing a thousand animals with bones ¹ or a or a cart-load of animals without bones.
api vāsthanvatām ekaikasmin kiṃcid dadyāt /	Or else, he may give some small amount for each animal with bones that he has killed. If someone kills a eunuch,* he should give a load of straw and a Māșa (G .
varāhe ghṛtadhaṭaḥ / sarpe lohadaṇḍaḥ / brahmabandhvāṃ calanāyāṃ nīlaḥ / vaiśikena kiṃcit /	n.) of lead; if he kills a boar, a pot of ghee; if he kills a snake, an iron bar; if he kills a wanton woman who is a Brahmin only in name, a leather bag; and if he kills a prostitute, nothing at all.
dve paradāre / trīṇi śrotriyasya /	Adultery, Drinking, and Other Sins If someone frustrates the acquisition of a wife, food, or wealth, for each such offence he should observe a life of chastity for one year; if he commits adultery, for two years; and if he does so with the wife of a vedic scholar, for three years.
yathāsthānaṃ vā gamayet /	If he has received anything from her, he should throw it away or return it to its owner.
pratiṣiddhamantrayoge sahasravākaś cet / agnyutsādinirākṛtyupapātakeṣu caivam /	If someone employs ritual formulas on behalf of proscribed people, he should observe a life of chastity for one year if the formulas contained a thousand words; as also a man who extinguishes his sacred fires, neglects vedic recitation, or commits a secondary sin causing loss of caste, and a woman who goes against her husband.
strī yāticāriṇī guptā piṇḍaṃ tu labheta /	She should be kept under watch, however, and receive food.
amānuṣīṣu govarjaṃ strīkṛte kūṣmāṇḍair ghṛtahomoghṛtahomaḥ /	If someone has sex with an animal other than a cow,* he should offer ghee in the sacred fire while reciting the Kūṣmāṇḍa verses.
surāpasya brāhmaṇasyoṣṇām āsiñceyuḥ surām āsyemṛtaḥ śudhyet /	They should pour hot liquor into the mouth of a Brahmin who has drunk liquor. He is purified after he dies.
amatyā pāne payo ghṛtam udakaṃ vāyuṃ pratitryahaṃtaptāni sa kṛcchras tato 'sya saṃskāraḥ /	If he has drunk it inadvertently, he should subsist on hot milk, hot ghee, hot water, and hot air, for a period of three days each; this is the arduous penance (cf.
śvāpadoṣṭrakharāṇāṃ cāṅgasya /	B ..-). After that he should undergo initiation.
grāmyakukkuṭasūkarayoś ca /	The same penance should be performed when someone consumes urine, excrement, or semen, as also a part of a predatory animal, a camel, or a donkey, $or of a village cock or pig.
gandhāghrāṇe surāpasya prāṇāyāmā ghṛtaprāśanaṃ ca /	If someone smells the breath of a man who has drunk liquor, he should control his breath and eat some ghee, as also when he is bitten by an animal mentioned above.
pūrvaiś ca daṣṭasya /	Incestuous Sex A man who has had sex with the wife of an elder (A ..
liṅgaṃ vā savṛṣaṇam utkṛtya añjalāv ādhāyadakṣiṇāpratīcīṃ vrajed ajihmam ā śarīranipātāt /	n.) should lie on a heated iron bed; 'embrace a red-hot column (A .. n.); ¹ or tear out his penis together with the testicles and, holding them in his cupped hands, walk straight toward the south-west until he collapses.
mṛtaḥ śudhyet /	He is purified after he dies.
sakhīsayonisagotrāśiṣyabhāryāsu sunuṣāyāṃ gavi cagurutalpasamaḥ /	Sex with one's female friend or sister, a woman belonging to one's lineage (A .. n.), the wife of one's pupil, one's daughter-in-law, and a cow is equal to sex with the wife of an elder.
avakara ity eke /	According to some, it is equal to a student's breaking the vow of chastity.
śvabhir ādayed rājā nihīnavarṇagamane striyaṃprakāśam / pumāṃsaṃ ghātayet(han) / yathoktaṃ vā /	Illicit Sex ¹ If a woman has sex with a low-caste man, the king should have her publicly devoured by dogs ¹ and have the man executed, or punish him in the manner stated above (G .).
gardabhenāvakīrṇī nirṛtiṃ catuṣpathe yajet /	Breaking the Vow of Chastity A student who has broken his vow of chastity should sacrifice a donkey to Nirṛti at a crossroad.
tasyājinam ūrdhvabālaṃ paridhāya lohitapatraḥ saptagṛhān bhakṣaṃ caretkarmācakṣāṇaḥ /	Wearing its skin with the hairy side out and carrying a red bowl, he should beg food from seven houses while proclaiming his deed.
saṃvatsareṇa śudhyet /	He will be purified in a year.
retaḥskandane bhaye roge svapne 'gnīndhanabhaikṣacaraṇāni saptarātram akṛtvājyahomaḥ samidho vāretasyābhyām /	If he discharges semen out of fear, because of an illness, or in sleep, or if he neglects to put wood into the sacred fire or to go begging for food, he should offer ghee or two pieces of firewood in the sacred fire reciting the two Retasyā verses.
sūryābhyudito brahmacārī tiṣṭhed(sthā)	Miscellaneous Sins Someone who is asleep at sunrise should stand during that day, remaining chaste and without eating any . food; while someone who is asleep at sunset should stand during that night reciting the Savitrī verse.
aśuciṃ dṛṣṭvā ādityam īkṣeta prāṇāyāmaṃ kṛtvā /	When someone sees a sordid man (A ..-), he should control his breath and look at the sun.
trirātrāvaram abhojanam / saptarātraṃ vā svayaṃśīrṇāny upabhuñjānaḥphalāny anatikrāman /	Dharmasutras Eating Improper Food If a man eats something unfit to be eaten or consumes an impure substance, he should rid himself of all the excrement by not eating for at least three days; or else he should subsist for seven days on fruits that have fallen on their own without skipping any.* If he eats anything listed before the animals with five claws (G .-), he should throw up and eat some ghee. Sins of Speech If someone uses abusive words, tells a lie, or inflicts an injury, he shall practise austerities for a maximum of three days.
satyavākye vāruṇīmānavībhir homaḥ /	If his words were true, however, he should offer a sacrifice using the Vāruņī formulas and the Mānavī hymns.
vivāhamaithunanarmārtasaṃyogeṣv adoṣam eke 'nṛtam / na tu khalu gurvartheṣu /	According to some, telling a lie at a marriage, during sex, in jest, or in grief is not a sin, but not if it concerns an elder (A ..
sapta puruṣānitaś ca parataś ca hanti manasāpiguror(guru)	n.), ³¹ because when a man tells a lie with regard to an elder even in his mind and even with respect to something trivial, he brings ruin upon himself and upon seven generations before him and after him.
amatyā dvādaśarātraḥ / udakyāgamane trirātras /	Illicit Sex If someone has sex with a low-caste woman, he should perform an arduous penance (B ..) for a year; ³³ for twelve days, if he does it inadvertently; for three days, if he has sex with a woman during her menstrual period.
rahasyaṃ prāyaścittam avikhyātadoṣasya /	Secret Penances ¹ For sins unknown to the public, a man may perform a secret penance.
caturṛcaṃ taratsamandīty apsu japed apratigrāhyaṃpratijighṛkṣan pratigṛhya vā /	A person who yearns to accept or actually accepts something that he is forbidden to accept should stand in water and recite the four Taratsamandī verses, ³ while a person who yearns to eat food that is unfit to be eaten should sprinkle some earth on it.
ṛtvantarāramaṇa udakopasparśanāc chuddhim eke /	A man who has sex with a woman during her menstrual period, according to some, is purified by bathing, while, .
strīṣu /	according to others, this applies only when the woman is his wife.
payovrato vā daśarātraṃ ghṛtena dvitīyam adbhistṛtīyaṃ athānyat /	n.) is this. He should live on milk for ten days, on ghee for a second ten-day period, and on water for a third ten-day period, partaking of these only once a day in the morning. During this period he should keep his clothes wet and make offerings of his hair, nails, skin, flesh, blood, sinews, bones, and marrow in the sacred fire, saying at the conclusion of each offering: 'I offer in the mouth of the self, in the jaws of death.' And this is another penance for it.
ukto niyamaḥ /	The observances are the same as above.
agne tvaṃ pārayeti (RV 1,189.2)	He should offer ghee in the sacred fire, while reciting the verse 'You, O Fire, take us across .
tadvrata eva vā brahmahatyāsurāpānasteyagurutalpeṣuprāṇāyāmais tānto 'ghamarṣaṇaṃ japan samam aśvamedhāvabhṛthenedaṃca #	Alternatively, for the murder of a Brahmin, for drinking liquor, for stealing, and for having sex with the wife of an elder (A .. n.), a man may perform the same observance, tire himself out by controlling his breath, and silently recite the Aghamarṣaṇa hymn.
sāvitrīṃ vā sahasrakṛtva āvartayan punītehaivātmānam /	This is equal to participating in the ritual bath at the end of a horse sacrifice. Or else, a man may indeed purify himself by reciting the Sāvitrī verse one thousand times.
antarjale vāghamarṣaṇaṃ trir āvartayansarvapāpebhyo vimucyate /	By reciting the Aghamarṣaṇa hymn three times while standing in water a man is freed from all sins.
tad āhuḥ katidhāvakīrṇī praviśatīti / marutaḥ prāṇenendre balena bṛhaspatiṃbrahmavarcasenāgnim evetareṇa sarveṇeti / so 'māvāsyāyāṃ niśy agnim upasamādhāyaprāyaścittājyāhutīr juhoti / kāmāvakīrṇo 'smy avakīrṇo 'smi kāmakāmāyasvāhā /	So, they ask: 'Into how many does a student who has broken his vow of chastity enter?”—²'Into the Maruts with his breaths; into Indra with his strength; into Bṛhaspati with the splendour of his vedic learning; and into just the Fire with everything else.' ³ Such a student should kindle the sacred fire on the night of the new moon and offer as penance two oblations of ghee, while reciting: ‘O Lust, I have spilled semen! I have spilled semen, O Lust! To Lust, Svāhā!' and 'O Lust, I have been squeezed out! I have been squeezed out, O Lust! To Lust, Svāhā!' He should then put a piece of firewood into the fire, sprinkle water around the fire, offer the Yajnavāstu oblation, come near the fire, and worship it three times, reciting the verse 'May the Maruts sprinkle me.
traya ime lokā eṣāṃ lokānām abhijityā abhikrāntyāiti /	There are three . Dharmasutras worlds here; he does this to conquer these worlds, to subjugate these worlds.
etad evaikeṣām karmādhikṛtya yo 'prayata iva syāt saitthaṃ juhuyād ittham anumantrayeta varo dakṣiṇeti prāyaścittamaviśeṣāt anārjavapaiśunapratiṣiddhācārānādyaprāśaneṣu śūdrāyāṃ ca retaḥ siktvā(sic)	Some take this same rite to be a universally applicable penance, saying with regard to it: 'A man who is in some way impure should make an offering and recite the ritual formulas in the above manner, giving a choice gift as the sacrificial fee.' When someone cheats, slanders, does forbidden things, eats forbidden foods; when someone ejaculates his semen in a Sūdra woman or in any place other than the vagina (B .. n.); or when someone performs witchcraft even intentionally-he should bathe, reciting the Ablinga or Vāruṇī formulas, or other purificatory texts.
pratiṣiddhavāṅmanasāpacāre vyāhṛtayaḥ pañcasatyāntāḥ /	If someone commits an offence by speaking or thinking of something forbidden, he should recite the five Calls (cf. G . n.).
sarvāsv apo vācāmed ahaś ca mādityāś ca punātuiti prātā rātriś ca mā varuṇaś ca punātv iti sāyam / aṣṭo vā samidha ādadhyād devakṛtasyeti hutvāeva sarvasmād enaso mucyate /	Alternatively, for all sins he may sip water in the morning reciting, 'May the day and the sun purify me', and in the evening reciting, 'May the night and Varuņa purify me.' ¹ºOr else, by merely offering eight pieces of firewood into the sacred fire while reciting the formulas 'You are the expiation of sins committed against the gods . one is freed from all sins (B ..–).
athātaḥ kṛcchrān vyākhyāsyāmaḥ /	Arduous Penances ¹ Next we will describe the three types of arduous penances.
athāparaṃ try ahaṃ na kaṃcana yāceta / athāparaṃ try aham upavaset /	During three days a man should eat in the morning food fit for sacrifice and not eat anything in the evening; ³ during the next three days he should eat only in the evening; during the following three days he should not request food from anyone; and during the final three days he should fast.
rauravayaudhājape nityaṃ prayuñjīta(prayuj) /	A person who wants the penance to act quickly should remain standing during the day and seated at night; speak the truth; not talk with non-Aryas; 'sing the Raurava and Yaudhājaya Sāmans every day; ¹⁰bathe at dawn, noon, and dusk while reciting the verses 'Waters, you are refreshing .
anusavanam udakopasparśanam āpo hi ṣṭhetitisṛbhiḥ pavitravatībhir mārjayīta(mṛj)	and dry himself while reciting the eight purificatory verses 'Golden-coloured, pure, and purifying .
athodakatarpaṇam / namo 'hamāya mohamāya maṃhamāya dhanvate tāpasāyapunarvasave namaḥ / etad evādityopasthānam / etā evājyāhutayaḥ /	Next, he offers libations of water, saying Homage-to the creator of egoconsciousness, to the creator of illusion, to the giver of gifts, to the effacer of sins, to the performer of austerities, to PunarvasuHomage! Homage to the one worthy of Muñja grass offerings, to the one worthy of water offerings, to the one who finds wealth, to the one who finds all-Homage! Homage to the one who assures success, to the one who assures total success, to the one who assures great success, to the one who best assures success-Homage! Homage to Rudra, to the Lord of cattle, to the Great God, to the Three-eyed God, to the Lone Itinerant, to the Supreme Lord, to Hari, to Śarva, to Īśāna, to the Dread God, to the Wielder of the Thunderbolt, to the Violent God, to the Matted God-Homage! Homage to the Sun, to Aditya-Homage! Homage to the Blue-necked God, to the Dark-throated God-Homage! Homage to the Black God, to the Brown God-Homage! Homage to the First-born God, to the Best God, to the Eldest God, to Indra, to the Yellow-haired God, to the Continent GodHomage! Homage to the True God, to the Purifying God, to the Fire-coloured God, to Passion, to the God whose form is passion-Homage! Homage to the Brilliant God, to the God of brilliant form-Homage! Homage to the Fiery God, to the God of fiery form-Homage! Homage to Sobhya, to the Fine Man, to the Great Man, to the Middle Man, to the Highest Man, to the Chaste Student-Homage! ..
dvādaśarātrasyānte caruṃ śrapayitvā(śrā)	Dharmasutras Homage to the God who wears the moon on his forehead, to the God who wears a skinHomage! (cf.
agnaye(agni)	SāmB ..) The worship of the sun is carried out in the very same manner, ¹ as also the offering of ghee in the sacred fire.
tato brāhmaṇatarpaṇam / etenaivātikṛcchro vyākhyātaḥ / yāvat sakṛd ādadīta(ādā)	At the end of the twelve days, he should cook an oblation of milk rice and offer it in the sacred fire to the following deities, saying, To Fire Svāhā! To Soma Svāhā! To Fire and Soma Svāhā! To Indra and Fire Svāhā! To Indra Svāhā! To All-gods Svāhā! To Brahman Svāhā! To Prajāpati Svāhā! To Fire who makes the offering flawless Svāhā!' After that he should gratify the Brahmins These very rules explain the procedure of the very arduous penance, ¹ at which he should eat only as much as he can take in a single mouthful.
abbhakṣas tṛtīyaḥ sa kṛcchrātikṛcchraḥ /	Taking only water is the third type of arduous penance, and it is called the 'penance beyond the very arduous penance'.
prathamaṃ caritvā śuciḥ pūtaḥ karmaṇyo bhavati /	By performing the first, a man becomes pure, cleansed, and fit to engage in the occupations of his class.
dvitīyaṃ caritvā yatkiṃcid anyan mahāpātakebhyaḥpāpaṃ kurute tasmāt pramucyate /	By performing the second, he is freed from all except the grievous sins causing loss of caste.
tṛtīyaṃ caritvā sarvasmād enaso mucyate /	By performing the third, all his sins are wiped away.
athaitāṃs trīn kṛcchrāṃś caritvā sarveṣu vedeṣusnāto bhavati sarvair devair jñāto bhavati / yaś caivaṃ veda /	By performing all three types of arduous penances, he becomes a bath-graduate with respect to all the Vedas, he becomes known to all the gods- so also a man who knows this.
athātaś cāndrāyaṇam /	Lunar Penance Next, we will describe the lunar penance. To it also apply the rules given under arduous penance.
tasyokto vidhiḥ kṛcchre / vapanaṃ vrataṃ caret / śvobhūtāṃ paurṇamāsīm upavaset /	A person who performs this as a penitential vow should shave his head. On the day before the full moon he should fast. He should offer libations of water, offer ghee in the sacred fire, consecrate the sacrificial oblation, and worship the moon using the following formulas: 'Swell up .
āpyāyasva (RV 1,91.17)	May the juices unite in you .
yad devā devaheḍanam iti catasṛbhirjuhuyāt /	and 'Being born, it becomes ever new ... He should offer ghee in the sacred fire, reciting the four verses 'O gods, whatever . offence we have committed against the gods . and at the end put pieces of firewood into the fire, reciting the formulas 'You are the expiation for sins committed against the gods .
oṃ bhūr bhuvaḥ svas tapaḥ satyaṃ yaśaḥ śrīr ūrgiḍaujas tejo varcaḥ puruṣo dharmaḥ śiva ity etair grāsānumantraṇaṃpratimantraṃ # namaḥ svāheti vā sarvān /	The mouthfuls of food should be consecrated by mentally reciting these formulas, one for each mouthful: ‘OM! Earth! Mid Space! Sky! Austerity! Truth! Fame! Prosperity! Vigour! Refreshment! Strength! Lustre! Male! Law! Auspicious!'; 'or else he may consecrate all of them, saying 'Homage Svāhā!” The mouthfuls shall be of such a size as not to distend the mouth.
grāsapramāṇam āsyāvikāreṇa / carubhaikṣasaktukaṇayāvakaśākapayodadhighṛtamūlaphalodakānihavīṃsyuttarottaraṃ praśastāni /	The sacrificial oblations are milk rice, almsfood, barley flour, husked grain, barley gruel, vegetables, milk, curd, ghee, roots, fruits, and water, each succeeding being more excellent than each preceding.
paurṇamāsyāṃ pañcadaśa grāsān bhuktvāekāpacayenāparapakṣam aśnīyāt /	On the full-moon day he should eat fifteen mouthfuls, and during the fortnight of the waning moon reduce the amount of food by one mouthful a day. On the new-moon day he should fast, and during the fortnight of the waxing moon increase the amount of food by one mouthful a day.
viparītam ekeṣām /	Some invert this procedure (B .. n.).
evaṃ cāndrāyaṇo māsaḥ /	This is a month of the lunar fast.
evam āptvā vipāpo vipāpmā sarvam eno(enas)hanti /	A man who completes one such month becomes free from sin, free from evil; and he wipes out all offences.
dvitīyam āptvā daśa pūrvān daśa parān ātmānaṃcaikaviṃśaṃ paṅktiṃ ca punāti /	A man who completes a second such month purifies his ten ancestors and ten descendants, with himself as the twenty-first, and also those alongside whom he eats (A..
saṃvatsaraṃ cāptvā candramasaḥ salokatām āpnotisalokatām āpnoti /	n.). A man who completes one year in this manner will dwell in the same world as the moon.
ūrdhavaṃ pituḥ(pitṛ)	INHERITANCE ¹ After their father's death, the sons may divide the estate, or, if the father so wishes, even during his lifetime but after their mother has reached menopause.
sarvaṃ vā pūrvajasyetarān bibhṛyāt pitṛvat /	Alternatively, the eldest son may inherit the entire estate, and he should maintain the others just as the father.
vibhāge tu dharmavṛddhiḥ /	When the estate is partitioned, however, ritual activities increase.
viṃśatibhāgo jyeṣṭhasya mithunam ubhayatodadyukto rathogovṛṣaḥ /	The additional share of the eldest son consists of Dharmasutras one-twentieth of the estate, a pair of livestock, a carriage yoked to animals with teeth in both jaws (G .
kāṇakhorakūṭavaṇetā madhyamasyānekāścet /	n.), and a bull. The additional share of the middle son consists of animals that are one-eyed, old, hornless, and tailless, if there are more than one of these in the herd.
avir dhānyāyasī gṛhamano yuktaṃ catuṣpādaṃcaikaikaṃ yavīyasaḥ /	The additional share of the youngest son consists of sheep, grain, iron utensils, a house, a cart yoked with oxen, and one of each kind of livestock.
samadhā cetaratsarvam /	All the rest are to be divided equally.
dvyaṃśī vā pūrvajasya / ekaikam itareṣām /	Alternatively, the eldest son may take two shares, ¹ and the others one each. Or else, each son may take one kind of property, selecting according to seniority whatever he likes, ¹ as also ten heads of livestock, but not of one-hoofed animals or slaves.
daśakaṃ paśūnām /	A bull is the additional share of the eldest, ¹ while fifteen cows and a bull are the additional share of the eldest son from the seniormost wife.
naikaśaphadvipadām / ṛṣabho 'dhiko jyeṣṭhasya / ṛṣabhaṣoḍaśā jyaiṣṭhineyasya /	Alternatively, the eldest son born from a wife who is not the seniormost may receive a share equal to that of his younger brothers born from the seniormost wife.
pratimātṛ vā svasvavarge bhāgaviśeṣaḥ /	Or else, the special shares are fixed within each group of brothers from the same mother.
pitotsṛjet putrikāṃ anapatyo 'gniṃprajāpatiṃ ceṣṭvāsmadartham apatyam iti saṃvādya /	Appointed Daughter A father who has no son should offer an oblation to Fire and Prajāpati, proclaim 'Your son is for my benefit', and appoint his daughter.
abhisaṃdhimātrāt putrikety ekeṣām /	According to some, he may appoint the daughter by his mere intention.
tatsaṃśayān nopayacched abhrātṛkām /	Because of this uncertainty, a man should not marry a girl who has no brother.
piṇḍagotrarṣisaṃbandhā rikthaṃ bhajeran strīvānapatyasya /	Property of a Sonless Man The estate of a man who dies sonless is shared by those related to him through ancestry (A ..
bījaṃ vā lipseta /	n.), lineage, or a common seer (A .. n.), and by his wife. Levirate Alternatively, the widow may seek to procure a son.
strīdhanaṃ duhitṛṛṇām aprattānām apratiṣṭhitāṇāṃ ca / bhaginīśulkaḥ sodaryāṇām ūrdhvaṃ mātuḥ(mātṛ) /	When her brother-in-law is alive, a son born to such a widow by another person does not share in the inheritance. Women's Property The wife's property goes to her daughters . who are unmarried or indigent. A sister's dowry goes to her uterine brothers after her mother dies, or, according to some, even before.
asaṃsṛṣṭivibhāgaḥ pretānāṃ jyeṣṭhasya /	Inheritance after Partition When a brother who, after partitioning, has not reunited dies, the eldest brother takes his estate.
vibhaktajaḥ pitryam eva /	When a brother who, after partitioning, has reunited dies, his coparcener takes his estate. When a son is born after the partition, he alone inherits the paternal estate.
svayam arjitam avaidyebhyo vaidyaḥ kāmaṃ na dadyāt / avaidyāḥ samaṃ vibhajeran /	Estates of Copaceners A learned coparcener, if he so wishes, does not have to give what he has earned on his own to his coparceners who are not learned, ¹ whereas coparceners who are not learned should share equally what they have earned on their own.
putrāaurasakṣetrajadattakṛtrimagūḍhotpannāpaviddhā rikthabhājaḥ / kānīnasahoḍhapaunarbhavaputrikāputrasvayaṃdattakrītā gotrabhājaḥ /	Legal Heirs A natural son, a son begotten on the wife, a son given in adoption, a contrived son, a son born in secret, and a son adopted after being abandoned by his birth parents-these share in the inheritance. A son of an unmarried woman, a son born to a woman who was pregnant at marriage, a son born to a re-married woman, a son born to an appointed daughter, a son who hands himself over for adoption, and a purchased sonthese share in the lineage* (A ..
caturthāṃśina aurasādyabhāve /	n.) and receive onequarter of the estate in the absence of the sons in the list beginning with the natural son.
brāhmaṇasya rājanyāputro jyeṣṭho guṇasaṃpannastulyabhāk /	A son born to a Brahmin by a Kşatriya wife, if he happens to be the eldest and possesses good qualities, receives an equal share of the estate, but he is not entitled to the additional share reserved for the eldest son.
rājanyāvaiśyāputrasamavāye yathā sabrāhmaṇīputreṇa / kṣatriyāc cet /	When a Brahmin has sons by Kşatriya and Vaisya wives, the division takes place in the same way as between sons by Brahmin and Kṣatriya wives; so also when a Kşatriya has such sons.
śūdrāputro 'py anapatyasya śuśrūṣuś cel labhatevṛttimūlam antevāsividhinā /	When his father dies without heirs, even a son by a Śūdra wife may receive a share sufficient to maintain himself, if he has been obedient like a pupil (cf.
savarṇāputro 'py anyāyyavṛtto na labhetaikeṣām /	According to some, even a son by a wife of the same class as Dharmasutras . the husband does not receive a share of the inheritance if he lives an unrighteous life.
śrotriyā brāhmaṇasyānapatyasya rikthaṃ bhajeran / rājetareṣām /	When a Brahmin dies childless, Vedic scholars should divide his estate among themselves; ² or, according to some, the king should take it.
jaḍaklībau bhartavyau /	Mentally retarded and impotent brothers should receive maintenance, whereas a son of a mentally retarded brother receives a share of the inheritance.
śūdrāputravat pratilomāsu /	When a man fathers sons through women belonging to a caste higher than his, they are to be treated like the sons by a Sūdra wife.
udakayogakṣemakṛtānneṣv avibhāgaḥ / strīṣu ca saṃyuktāṣu /	Sources of water, security measures, and cooked food are not to be divided, as also women belonging to the family.
anājñāte daśāvaraiḥ śiṣṭair ūhavidbhir alubdhaiḥ praśastaṃ kāryam /	RESOLVING DOUBTS REGARDING THE LAW In matters that are unclear, one should follow what is endorsed by a minimum of ten persons who are cultured, skilled in reasoning, and free from greed.
catvāraś caturṇāṃ pāragā vedānāṃ prāg uttamāttraya āśramiṇaḥ pṛthag dharmavidas traya etān daśāvarān pariṣad #	A legal assembly is said to consist of a minimum of ten members-four who have mastered the four Vedas; three belonging to the three orders enumerated first; and three who know three different Legal Treatises. When such persons are unavailable, however, one should follow in doubtful cases what is recommended by a learned and cultured Brahmin who knows the Veda, because such a man is incapable of hurting or favouring creatures. A man who knows the Law, by his knowledge of and adherence to the Law, obtains the heavenly world to a greater degree than those who follow the Law. That is the Law. That concludes the Gautama Dharmasūtra The Dharmasutra of Baudhāyana THE Dharmasūtra of Baudhāyana, as that of Apastamba, forms part of the Kalpasūtra ascribed to this eponymous author and divided into praśnas (lit., 'questions') or books.
asambhave tv eteṣāṃ śrotriyo vedavicchiṣṭovipratipattau yad āha /	There is scholarly agreement that the last two books of the Dharmasūtra are later additions (Bühler –, ii, pp.
yato 'yam aprabhavo bhūtānāṃ hiṃsānugrahayogeṣu /	She cannot take part in rites for gods or ancestors, and Kaśyapa has declared her to be a slave. When people, bewitched by greed, deliver a daughter of theirs for a payment, these wicked men, selling their own selves and guilty of a heinous crime, fall into a gruesome hell, slay their families up to the seventh generation (G Dharmasutra of Baudhāyana . n.), and repeatedly die and are rebornall this is decreed when a payment takes place.
dharmiṇāṃ viśeṣeṇa svargaṃ lokaṃ dharmavid āpnotijñānābhiniveśābhyām /	ORDERS OF LIFE Argument of Opponents 'Now, some do indeed posit a fourfold division of this Law In the absence of a vedic text to support their position, Dharmasutra of Baudhāyana .. however, the text 'Four paths . must refer to rites, ¹ namely, Işți sacrifices, animal sacrifices, Soma sacrifices, and ghee offering * a division enunciated in this verse: Four paths leading to the gods traverse between heaven and earth.
