athaatas sāmayācārikān	Among these, each preceding class is superior by birth to each subsequent.
yaś caavidvān	dras are to serve the other classes the higher the class they serve, the greater their prosperity.
iti hi brāhmanam / tasminn abhijanavidyā saṃskartāram /	THE STUDENT Initiation Initiation is the consecration of a person seeking vedic knowledge carried out according to vedic rules,for a Brāhmaṇa declares The Savitrī verse is recited for the sake of all the Vedas. TeacherFrom darkness they surely enter into further darknessan ignorant man who performs an initiation, as also the person whom he initiates, states a Brāhmaṇa.
tasmiṃś caeva vidyākarmaantam dharmebhyaḥ /	So, to perform the initiation, he should try to get a learned and steadfast man born in a family noted for vedic learning, under whom he should complete his vedic studies unless that man deviates from the Laws.
yasmātdharmān sa ācāryaḥ /	The teacher is the person from whom a man gathers the Laws.
sa hi vidyātas taṃ /	He should never offend the teacher, for he gives birth to him by means of vedic knowledge.
tatśreṣṭhaṃ janma / śarīram eva mātāpitarau /	That is his most excellent birth his parents give birth only to his body. Dharmasutras Time of Initiation A Brahmin should be initiated in the spring, a Kşatriya in the summer, and a Vaiśya in the autumn a Brahmin in the eighth year from conception, a Kṣatriya in the eleventh, and a Vaiśya in the twelfth.
saptame brahmavarcasakāmam , aṣṭama āyuṣkāmam ,	When initiations are performed with an objective in mind, , a person seeking eminence in vedic knowledge should be initiated in the seventh year, a person seeking long life in the eighth, a person seeking power in the ninth, a person seeking an abundance of food in the tenth, a person seeking strength in the eleventh, and a person seeking cattle in the twelfth.
dvādaśe paśukāmam / ā ṣoḍaśād brāhmaṇasyaanātyaya ,	In the case of a Brahmin there is no lapse in postponing the initiation until the sixteenth year, in the case of a Kṣatriya until the twentysecond year, and in the case of a Vaiśya until the twentyfourth year, so as to ensure that the person has the capacity to carry out the observances that we are about to describe.
sāvitryāḥ kāla ṛtuṃ traividyakaṃ brahmacaryaṃ / athaupanayanam /	Failure to be Initiated If his time for initiation has lapsed, a man should live observing the rules of a student of the three Vedas for one season and then undergo initiation.
tataḥ saṃvatsaram udakaupasparśanam / atha /	For a year thereafter he should take a daily bath, after which time he may receive vedic instruction.
atha yasya pitā pitāmaha iti te / teṣām abhyāgamanaṃ bhojanaṃ vivāham iti ca /	When both the father and grandfather of a man have not been initiated, they are all called Brahmankillers. People should refrain from visiting them and from eating or contracting marriages with them.
teṣām prāyaścittam /	They may, if they so choose, do a penance such a person should perform for a year the same penance that was prescribed for a season when the initial time for initiation had lapsed and then undergo initiation.
athaupanayanaṃ tata udakaupasparśanam /	Thereafter, he should take a daily bathfor as many years as the number of uninitiated persons in his family.
saptabhiḥ pāvamānībhir “yad anti yac ca dūraka” iti etābhir yajuspavitreṇa sāmapavitreṇaāṅgiraseṇaiti / api vā vyāhṛtībhir eva /	He should take this bath while reciting the seven Pāvamānī verses that begin Whether near or afar, as well as the purificatory formulas called Yajuḥpavitra, Sāmapavitra, and Angirasa or else, while reciting just the Calls.
atha/	Thereafter, he may receive vedic instruction.
atha yasya prapitāmahaādi na upanayanaṃ te / teṣām abhyāgamanaṃ bhojanaṃ vivāham iti ca teṣām prāyaścittaṃ dvādaśavarṣāṇi traividyakaṃ brahmacaryaṃ	When no one can remember that any of a mans ancestors back to his greatgrandfather had been initiated, they are all called cremation grounds. People should refrain from visiting them and from eating or contracting marriages with them. They may, if they so choose, do a penancesuch a person should live observing the rules of a student of the three Vedas for twelve years and then undergo initiation.
/ athaupanayanaṃ tatas udakaupasparśanaṃ pāvamānīādibhiḥ //	Thereafter, he should take a daily bath while reciting the Pāvamānī verses and the rest .
atha gṛhamedhaupadeśanam / naadhyāpanam /	He may then be taught the rites to be performed by a householder but not receive vedic instruction.
tato yo tasya saṃskāro yathā prathame 'atikrame / tata ūrdhvaṃ prakṛtivat /	And after he has completed that, his sacramentary rite is performed in the same manner as when the initial time for initiation has lapsed. Afterwards, everything is done as at the regular initiation.
ācāryakule brahmacārivāsaḥ / aṣṭācatvāriṃśad varṣāṇi /	Residency An initiated person should reside as a student in his teachers house for fortyeight years, or for threequarters of that time, or for half that time, or for onequarter of that time the minimum is twelve years. A student who seeks to acquire vedic knowledge may not reside with anyone else. A Students Code of Conduct General Rules Next, the students code of conduct.
pādūnam, ardhena, tribhir vā /	Insignia He shall have his hair matted or, keeping just the topknot matted, let him shave the rest. The girdle of a Brahmin should be a triple string of Muñja grass, twisted clockwise ..
dvādaśaavaraardhyam /	A Brahmins staff should be of Palāśa wood, a Kṣatriyas the prop root of a banyan tree, and a Vaiśyas of Badara or Udumbara wood.
ācāryaadhīnaḥ anyatra /	Some prescribe just a wooden staff without regard to class.
hitakārī	His garment should be º made of hemp, flax, or antelope skin.
na /	Some, however, prescribe a garment dyed ochre.
tathā kṣāralavaṇamadhumāṃsāni /	It should be dyed madder for a Kṣatriya and yellow for a Vaiśya.
maithunaṃ na / / aṅgāni na /	The skin of a Harina deer or a black Eņa doe is prescribed for a Brahmin if he wears a black skin, he should not use it as a spread to sit or sleep on.
jaṭilaḥ, śikhājaṭas	The skin of a spotted Ruru antelope is prescribed for a Kṣatriya, and that of a billy goat for a Vaiśya. A sheep skin is suitable for all classes, and so is a shawl of sheep wool.
vā itarān /	For a Brāhmaṇa declares A person who desires to increase his Brahmanical might should wear only antelope skins, and a person who desires to increase his Kṣatriya might should wear only cloth garments, while a person who desires both should wear both. Over his upper body, however, he should wear only an antelope skin.
mauñjī / ajanavādaśīlaḥ / rahasśīlaḥ /	General RulesHe shall not watch dancing,nor visit casinos or fairs. He shall not be given to gossiping but keep things confidential.
guror udācāreṣv akartā svairikarmāṇi /	He shall not engage in recreational activities in places frequented by his teacher.
strībhir /	He shall speak with women only as much as is required.
aglāṃsnuḥ, akrodhanaḥ, anasūyuḥ /	He shall be gentle, calm, controlled, modest, firmly resolute, energetic, not given to anger, and free from envy.
sarvaṃ lābham gurave sāyaṃ prātar amantreṇa bhikṣācaryaṃ ,	Food Morning and evening he shall go out to beg with a bowl, soliciting from those who are not degraded or heinous sinners, and bringing all he receives to his teacher.
strīṇāṃ brahmacārī prajāṃ paśūn brahmavarcasam annādyaṃ /	For a Brāhmaṇa declares When women refuse a steadfast student, he robs them of their sacrifices, gifts, oblations, offspring, cattle, sacred learning, and food supply.
tasmād u ha vai brahmacārisamghaṃ na , api haeṣv evamvidha evaṃvrataḥ iti hi brāhmaṇam / naanumānena bhaikṣam ucchiṣṭaṃ tu /	One should never refuse a group of students come to beg, therefore, for among them there may be one who is like that and who keeps that vow. Almsfood should not be considered leftovers by inference, but only through perception or testimony.
bhavatpūrvayā brāhmaṇo /	A Brahmin should beg placing Madam at the beginning, a Kşatriya placing Madam in the middle, and a Vaiśya placing Madam at the ..
tat ācāryāya /	He should eat it when the teacher invites him to do so.
vipravāse guror ācāryakulāya / tair vipravāse 'anyebhyo 'api śrotriyebhyaḥ /	If the teacher is not at home, he should announce it to a member of the teachers family, and, if they also are not at home, to some other vedic scholar.
naātmaprayojanaś /	Let him never go out to beg just for his own benefit.
svayam amatraṃ /	After he has eaten, he should wash his bowl himself.
na ca /	Let him not leave any food uneaten.
apsu vā / āryāya vā / antardhine vā śūdrāya /	If he is unable to do so, he should bury the leftovers in the ground, throw them in water, or place them before an Arya or before a Sūdra who is a family servant.
bhaikṣād agnau /	When he is away from home, he should eat after offering some of the almsfood in the sacred fire.
bhaikṣaṃ haviṣā tatraācāryo devatāarthe / āhavanīyaarthe ca /	Almsfood is hailed as a sacrificial oblation at which the teacher plays the roles of the deity and the offertorial fire .
yad anyāni dravyāṇi yathālābham dakṣiṇā eva tāḥ /	When, after feeding his teacher,he eats what is left over that is indeed the leftovers from a sacrificial oblation . When he gives to the teacher other things as he obtains them, they are truly the sacrificial fees.
sa eṣa brahmacāriṇo yajño /	This is the sacrifice performed daily by a student.
na caasmai / yathā kṣāralavaṇamadhumāṃsāniiti /	The teacher should not give him any leftover items of food which are forbidden to him by vedic texts, however, items such as spices, salt, honey, and meat.
caapi pravṛttikāraṇam /	His other restrictions are also intimated by this rule, for a vedic text has greater force than a practice from which the existence of a corresponding vedic text has to be inferred .
pitur jyeṣṭhasya ca bhrātur / dharmavipratipattāv / sāyaṃ prātar udakumbham / sadāāraṇyād edhān adho /	We notice here, moreover, a motive for such a practice, for one derives pleasure from it .It is permissible to eat the leftovers of ones father or an older brother, but not if it would result in breaking the Law . Dharmasutras Fire Worship At dusk and dawn a student should fetch a pot of water, and every day he should gather firewood from outlying areas and pile it on the ground.
na samiddhāro /	After sunset he should not go out to gather firewood.
agnim samidha sāyaṃ prātar yathāupadeśam /	At dusk and dawn, after he has lighted the fire and swept around it, he should put firewood into it according to the instructions.
sāyam evaagnipūjāity eke /	Some say that he needs to perform the fire worship only at dusk.
agniṃ pāṇinā na samūhanyā / prāk tu yāthākāmī /	After he has lighted the fire, he should sweep around it with his hand and not with a broom, but before lighting it he may do as he pleases.
naagniudakaśeṣeṇa vṛthākarmāṇi vā / pāṇisaṃkṣubdhenaudakena ca na /	Let him not use the remainder of the water from the fire worship to carry out mundane activities or for sipping, nor sip water that has been stirred with the hand or poured into one hand.
svapnaṃ ca / athaaharahar ācāryaṃ karmabhiḥ /	Conduct towards the Teacher He should forgo sleep and every day take care of his teacher with activities that procure righteousness and wealth .
sa dharmagopāyam aham iti / pramādād ācāryasya buddhipūrvaṃ vā niyamaatikramaṃ rahasi / anivṛttau svayaṃ karmāṇy , vā / atha yaḥ pūrvautthāyī jaghanyasaṃveśī tam na iti /	After taking care of his teacher, he should say when he goes to sleep I have taken care of the man who takes care of the Law. If the teacher breaks a rule through carelessness or deliberately, the student should point it out to him in private and if the teacher persists, he should either perform those rites himself or make him desist. Now, they say that a student who gets up before and goes to bed after his teacher never sleeps.
sa ya evaṃ brahmacāry atraevaasya sarvāṇi karmāṇi phalavanty yāny api gṛhamedhe /	A student who totally dedicates himself in this manner accomplishes in that very state all the rites carrying rewards, as well as those that pertain to a householder. General Rules The term austerity is used with reference to the rules of conduct.
tadatikrame vidyākarma brahma sahaapatyād etasmāt /	When someone breaks these rules, the application to vedic study and the knowledge of the Veda will slip away from him, as well as from his children he will fall into hell, and his life will be shortened.
tasmād ṛṣayo 'avareṣu na niyamaatikramāt /	As a result of breaking these rules, seers are not being born in recent generations.
yathā śvetaketuḥ /	Through a residue of their merits, however, some people are reborn as seers on account of their vedic learning, as, for example, Śvetaketu.
ācāryād brahmavad eva tasmin phalaṃ /	Whatever other science besides the Veda a steadfast man learns from his teacher, it will bear fruit for him just like the .. Veda.
athau yat kiñ ca manasā vācā cakṣuṣā vā vā tathāeva tad /	They point out, moreover, that when such a person thinks of anything, speaks about anything, or looks at anything with a will to accomplishing it, it will happen exactly as he wills.
karmāṇi svastyayanam adhyayanasaṃvṛttir iti /	Activities pleasing to the teacher, those promoting his own wellbeing, and pursuing his studies undertakings other than these do not belong to a student.
svādhyāyadhṛg dharmarucis tapsvy ṛjur mṛduḥ brahmacārī /	When a student is faithful to his private vedic recitation, takes delight in the Law, and is observant, upright, and gentle, he will attain success.
sadā mahāntam apararātram guros prātarabhivādam asāv ahaṃ bho iti / samānagrāme ca anyeṣām api vṛddhatarāṇāṃ prāk prātarāśāt /	Conduct towards the TeacherRising each day during the last watch of the night , he should stand before the teacher and extend to him the morning greeting ‘I am soandso, sir!, and, before the morning meal, to other very elderly persons living in the same village.
svargam āyuś ca /	He should also greet them when he meets them after he returns from a journey or if he desires heaven or long life.
śūdraḥ prañjalim /	With joined hands, let a Brahmin greet by stretching his right hand level with his ears, a Kşatriya level with his chest, a Vaisya level with his waist, and a Śūdra very low.
plāvanaṃ ca nāmno 'abhivādanapratyabhivādane ca pūrveṣāṃ varṇānām /	When returning the greetings of a person belonging to one of the higher classes, the last syllable of his name should be lengthened to three morae .
ācārya ity eke /	When he meets the teacher after sunrise, however, he should clasp his feet at all other times he should exchange greetings, although, according to some, he should embrace the teachers feet even at other times.
dakṣiṇena pāṇinā daksiṇaṃ pādam adhastād abhy sakuṣṭhikam /	After he has pressed his teachers right foot from the bottom to the top with his right hand, he should clasp it at the ankle.
ubhābhyām evaubhāv ity eke /	Some say that he should massage both feet with both hands and clasp them both.
sarvaahṇaṃ 'adhyayanād anantaro'adhyāye / tathā gurukarmasu /	He shall remain fully attentive all day long and at the time of vedic study never let anything distract him from his lesson, as also while he is attending to his teachers work.
manasā caanadhyāye /	At times when vedic recitation is forbidden, he shall recite it mentally.
ca / sadā niśāyāṃ guruṃ tasya pādau / /	And he should recite the Veda only when he is called upon to do so. Every night he should get his teacher ready for bed by washing and pressing his feet, and, when permitted, lie .. down to sleep himselftaking care not to stretch his legs towards the teacher.
na khaṭvāyāṃ sato 'abhiprasāraṇam ity eke / na caasya sakāśe / tv ,	According to some, however, it is not wrong to stretch the legs in that way if the teacher is lying on a bed. Dharmasutras In the presence of his teacher, moreover, he should not speak while lying down. If the teacher speaks to him, however, he may answer him while remaining seated or, if the teacher is standing, rising to his feet.
/ , /	Let him walk behind the teacher when he is walking and run after him when he is running.
na vā /	He should not come near the teacher wearing shoes, covering the head, or carrying anything in the hands.
adhvā tu vā / na ced /	He may do so, however, when he is on the road or in the middle of doing something, provided he does not sit too close to the teacher.
devam ivaācāryam avimanā vācaṃ 'asya /	Let him approach the teacher as he would a god, without idle talk or distracting thoughts and attentive to his words.
/ ,	He shall not sit crosslegged.
pāṇinā , 'anyatra /	He shall not sit supporting himself with his hand, or leaning against anything.
yajñopavītī dvivastraḥ / tv ekavastraḥ /	If he is wearing two garments, he should wear one of them over his left shoulder and under his right arm, but if he is wearing a single garment, he should wrap it around his lower body.
anāsanno 'anatidūre /	Let him face the teacher even when the teacher is not facing him, sitting neither too close nor too far, but at a distance where the teacher, while seated, can reach him with his hands.
aprativātam /	He shall not sit where the wind blows from the teacher to him.
ekaadhyāyī dakṣiṇaṃ bāhuṃ praty ,	A single student should sit on his teachers right, while a group may sit as space permits.
ca na / ca na /	When the teacher is not provided with a seat and remains standing, he should not sit down.
na caasya sakāśe 'anvaksthāninam / gotreṇa vā /	In the presence of the teacher, moreover, he should not clasp the feet of a person of lesser dignity than the teacher, greet such a person using the name of his lineage , rise to meet him, or get up after him, even if that person happens to be his teachers elder. But he should move away from that place and from his seat.
api cet tasya guruḥ /	Some say that he may address a pupil of his teacher by name, even if that pupil happens to be an elder .. of his .
yasmiṃs tv anācāryasaṃbandhād gauravaṃ vṛttis tasminn anvaksthānīye 'apy ācāryasya /	Towards a person who is revered for reasons other than being his teacher, however, he should behave as towards his teacher, even if he happens to be a person of lesser dignity than his teacher.
caasya sakāśe naucchiṣṭaṃ , vā /	After he has eaten in the presence of his teacher, moreover, he should neither give away his leftovers nor sip water without getting up.
tūṣṇīṃ vā /	After asking the teacher What shall I do?, he should get up or he may get up silently.
na guroḥ /	Let him not move counterclockwise but walk around his teacher clockwise and then leave.
na nagnāṃ striyam / oṣadhivanaspatīnām na /	General RulesHe should not look at a naked woman or cut anything from plants or trees to smell it.
na /	He should refrain from using shoes, umbrellas, and vehicles.
yadi iti hi brāhmaṇam /	Let him not smile, or, if he smiles, let him do so covering his mouth—so states a Brāhmaṇa.
na striyaṃ mukhena / na hṛdayena prārthayet /	He should not kiss a woman with his mouth, covet her in his heart, or touch her without a good reason.
rajasvalo raktadan satyavādī iti hi brāhmaṇam /	A Brāhmaṇa states He shall keep his body dirty, his teeth stained, and his speech true .
yāṃ vidyāṃ gurau te 'apy asyaācāryā ye tasyāṃ guror vaṃśyāḥ / yān anyān 'asya tadā tv ete upasaṃgrāhyāḥ /	He shall regard those who taught his teacher the same subject that he is studying from him as his own teachers. When he sees his teacher clasp the feet of other persons, he should also clasp their feet.
gurusamavāye bhikṣāyām yam tadadhīnā bhikṣā /	If he has several teachers, the almsfood he gathers comes under the control of the teacher to whom he is currently attached.
mātā bhartāraṃ , bhartā gurum /	A student who has returned home should offer the almsfood to his mother the mother should present it to her husband,and the husband to the teacher.
dharmakṛtyeṣu vā /	Or else, it may be used for ritual purposes.
vidyāṃ yāvatīṃ vedadakṣiṇām dharmato yathāśakti /	Conclusion of Study After learning as much as he can, he should present the fee for vedic study, a fee that is procured righteously and according to his ability.
viṣamagate tv ācārya ugrataḥ śūdrato vā	If his teacher has fallen into hardship, however, he may seize it from an Ugra or a Sūdra. Some maintain that it is lawful at all times to seize wealth for the teacher from an Ugra or a Śūdra.
ca na /	Let him not brag about what he has ..
ātmapraśaṃsāṃ paragarhām iti ca /	He should refrain from praising himself and disparaging others.
tad eva / śāstuś caanāgamād vṛttir anyatra / anyatraupasaṃgrahaṇād ucchiṣṭaaśanāc caācāryavad ācāryadāre vṛttiḥ /	When he is ordered to do something, he should go ahead and do just that. If the teacher is incompetent, however, he may live with another . With the exception of clasping the feet and eating the leftovers , he should behave towards his teachers wife as towards his teacher and conduct himself in the same manner towards a person whom the teacher deputes to teach him and towards older classmates.
ucchiṣṭaaśanavarjam ācāryavad ācāryaputre vṛttiḥ /	With the exception of eating the leftovers, he should behave towards his teachers son as towards his teacher. A STUDENT WHO HAS RETURNED HOME Conduct towards the Teacher Even after he has returned home, the accepted practice is that he should behave towards these individuals exactly the same way as he behaved when he was a student.
apy etad eva sāmayācārikam āpady arthaṃ /	The teacher, for his part, should not speak admiringly of his pupils belongings in the hope of getting them. Some, however, maintain that a bathgraduate who is summoned by or visits his teacher is not expected to take off what he had been wearing, in accordance with the rules, at the time of graduation.
saha sāyaṃ prātar guruṃ darśanaartho /	Let him not sit on a seat that is higher, has more legs or is sturdier than his teachers nor occupy a seat or bed that is normally used by his teacher. When he is so ordered by the teacher during a journey, he may get on to the same vehicle, but after the teacher.
ācāryaprācāryasaṃnipāte prācāryāyaupasaṃgṛhya ācāryam ,	If they live close by, he should go to see the teacher every morning and evening without being summoned and visit him the very day that he returns from a journey. When his teacher and his teachers teacher are together, he should first clasp the feet of his teachers teacher and then try to clasp his own teachers feet, but the latter should forbid him in the presence of his teachers teacher acts of reverence to his own teacher are suspended.
pūjā caasya sakāśe / muhūṃś caācāryakulaṃ darśanaartho yathāśakty adhihastyam api dantaprakṣālanāniiti /	He shall go frequently to visit his teacher at his home, bringing with him whatever personal gift he can afford, even if it is only a few tooth cleaners. ..
tasmin guror vṛttiḥ /	Duties of a Teacher Next, the teachers conduct towards his pupil.
putram ivaenam sarvadharmeṣv vidyāṃ /	Loving him like a son and totally devoted to him, the teacher should impart knowledge to him without holding anything back with respect to any of the Laws.
na caenam adhyayanavighnenaātmaartheṣu anāpatsu /	Except in an emergency, moreover, he should not employ a pupil for his own purposes to the detriment of the pupils studies.
ācāryo 'apy anācāryo /	A pupil ceases to be a pupil when he is inattentive to his teacher and so becomes a dolt. A teacher, likewise, ceases to be a teacher when he neglects teaching.
aparādheṣu caenaṃ satatam /	When people condemned to death remain in prison, it is suspended until they have been executed.
abhitrāsa upavāsa udakaupasparśanam adarśanam iti daṇḍā yathāmātram ā nivṛtteḥ /	This is its procedure he should go near the water before breakfast, purify himself, and, leaving out the chapter he has already finished, do his recitation at a clean spot aloud or, if it is a time for suspending recitation, mentally.
anyebhyo dharmebhyo 'anantaro ity /	With respect to particulars not given here, one should follow the directives of legal assemblies. Private Recitation of the Veda Private vedic recitation is austerityso states a Brāhmaṇa .
śrāvaṇyāṃ paurṇamāsyām adhyāyam māsaṃ pradoṣe na /	Study and Conduct towards the Teacher A teacher cannot give orders to a pupil of his who has returned home. The syllable OM is the gate to heaven. Therefore, when he is about to recite the Veda, he should pronounce that syllable at the beginning, as also after saying something during the recitation that is not part of the recitation. In this way the Veda is kept separate from ordinary speech.
taiṣyāṃ paurṇamāsyāṃ rohiṇyāṃ vā /	According to some, the pupil should do so always if the instructor is a worthy person.
ardhapañcamāṃś caturo māsān ity eke /	Dharmasutras Return to Studentship "The Veda waxes strong, they teach.Śvetaketu says If a man, after he has married and settled down, wishes to study the Veda further, he should live at the house of his teacher with a collected mind for two months every year, for by these means I managed to study more of the Veda than during the time I was a student.
nigameṣv adhyayanaṃ /	If by chance he is unable to complete his studies, subservience does indeed continue with respect to that teacher.
ānaḍuhena vā śakṛtpiṇḍena ' /	He should also clasp the feet of his brothers and sisters according to seniority. He should pay them homage, moreover, in the prescribed manner. He should rise up and greet an officiating priest, a fatherinlaw, or a paternal or maternal uncle who is younger than himself, or he may silently clasp his feet.
śmaśāne sarvataḥ śamyāprāsāt /	In every case, however, he should rise up before offering his greetings.
grāmeṇa kṣetreṇa vā naanadhyāyaḥ / tu tasminn eva deśe na /	He should never greet anyone with his shoes on, or with his head covered, or carrying anything in the hand. In greeting women, Kşatriyas, or Vaisyas, he should use a pronoun and not his personal name. Some maintain that he should do so also when he greets his mother or his teachers wife. A yearold Brahmin and a yearold Kṣatriya, you should know, stand with respect to each other as a father to a son.
śmaśānavacśūdrapatitau /	Purification He becomes pure by sipping water collected on the ground, or when a pure person gives him water to sip.
samānaagāra ity eke /	The proper place for a Brahmin to live is a village where there is a lot of firewood and water and where he is able to perform his purifications on his own.
śūdrāyāṃ tu prekṣaṇapratiprekṣaṇayor evaanadhyāyaḥ /	Food Unfit Food Meat that has been cut with a knife used for slaughtering is not fit to be eaten. He should not break off a piece of cake with his teeth.
tathāanyasyāṃ striyāṃ maithune /	When a death has occurred in a house, he should not eat there for ten days, as also after a birth before the mother comes out of the birthing room, and when there is a corpse in a house.
saṃbhāṣya tu brāhmaṇenaeva saṃbhāṣya /	Rules of Eating If, while he is eating, he is touched by a Śūdra, he should stop eating.
antaḥśavam / antaścāṇḍālam /	Eating Utensils He should eat out of a clay vessel that has not been used before, or, if it has been used, only after scorching it with fire. A vessel made of metal is purified by scrubbing, and one made of wood by scraping.
tu sīmny anadhyāyaḥ /	He should not consume anything that has turned sour without mixing it with some other food.
tad ahar ca grāmaṃ bāhyeṣu /	For a Brāhmaṇa states Mushrooms should not be eaten. The meat of onehoofed animals, camels, Gayal oxen, village pigs, and Śarabha cattle are forbidden. It is permitted to eat the meat of milch cows and oxen.
api satsu /	Alternatively, uncooked food may be accepted, or even cooked food if it does not contain any seasoning, but not a lot.
saṃdhāvanustanite rātrim /	He should not be overly attracted to this way of life and give it up when he finds his legitimate livelihood .
svapnaparyāntaṃ vidyuti /	As a rule, he may eat the food of a Brahmin, although it may become unfit to be eaten for a particular reason, as during a time when a person required to do a penance is performing the penitential act. After the man has concluded his penance, he may eat his food.
upavyuṣaṃ yāvatā vā kṛṣṇāṃ rohiṇīm iti śamyāprāsād etasmin kāle sapradoṣam ahar anadhyāyaḥ	He may eat it after paying for it with gold or an animal, but let him not be overly attracted to this way of life and give it up when he finds his legitimate livelihood. He shall not eat the food given by a corporate body or announced through a public invitation the food of anyone who lives by practising a craft or using weapons the food of a pawnbroker, a physician, or an usurer and, prior to the purchase of the Soma, the food of a man who has been consecrated for a sacrifice. Only after the animal dedicated to Agni and Soma has been killed or after its omentum has been offered, may one eat the food of a man consecrated for a sacrifice, for a Brāhmaṇa states ‘Alternatively, after setting aside the portion to be offered in sacrifice, they may eat the ..
dahre 'apararātre stanayitnunā /	He may eat the food given willingly by a pious person, but even when given by a pious person, he may not eat it if it is given unwillingly.
ūrdhvam ardharātrād ity eke /	He may eat food that he receives unasked from anyone at all, but, says Hārīta, not if it is received subsequent to an invitation. Now, they quote two verses from a Purāṇņa And further Almsfood brought and handed over even by an evildoer, in the opinion of Prajāpati, is suitable for eating, so long as it has not been previously announced.
gavāṃ caavarodhe /	A man plants a mango tree to get fruits, but in addition he obtains also shade and fragrance.
ca yāvatā /	In like manner, when a man follows the Law, he obtains, in addition, other benefits.
paśūnāṃ na /	The Righteous and the Unrighteous do not go around saying, Here we are! Nor do gods, Gandharvas, or ancestors declare, This is righteous and that is unrighteous." An activity that Āryas praise is righteous, and what they deplore is unrighteous.
ahorātrāv amāvāsyāsu /	The one who is immovable but resides within the movablethose who worship him become immortal.
cāturmāsīṣu ca /	The same applies for killing women of these classes.
vairamaṇo guruṣv aṣṭākya aupākaraṇa iti tryahāḥ /	he eats, or perform the arduous penance for a Now, they also quote year. Dharmasutras People who have committed a theft, drunk liquor, had sex with the wife of an elder so long as they have not killed a Brahminshould eat a little at every fourth mealtime, dip into water at dawn, noon, and dusk, and remain standing during the day and seated at night. Such people get rid of their sin in three years.
tathā saṃbandheṣu jñātiṣu /	These provisions apply also to women.
mātari pitary ācārya iti dvādaśaahāḥ /	Next, the penances for studying in contravention of the rules. Engaged in activities beneficial to his teacher, he should keep silence for a year, speaking only during his daily vedic recitation, when addressing his teacher or the teachers wife, and while he is begging.
teṣu caudakaupasparśanaṃ tāvantaṃ kālam /	The same applies also to other sinful acts that do not cause loss of caste, as do the penances that we will enumerate below. Alternatively, he should make an offering to Lust and Anger or recite softly Lust did it!, Anger did it! .
anubhāvināṃ ca parivāpanam /	Or else, he should offer Işțiofferings and Yajñakratusacrifices in order to purify himself. After eating something unfit to be eaten, he should fast until all the excrement is gone, which happens after seven days. Alternatively, he should bathe each morning and evening during the winter and spring, or perform the twelveday arduous penance.
na anyatra vihārād ity eke /	There are exceptions in the case of certain belongings, says Vārṣyāyaṇi such as legume pods or fodder for a draught ox. Owners normally do not forbid someone from taking these.
athaapi brāhmaṇam,	This principle applies also to other sinful acts and also to meritorious deeds. A Brahmin should not take a weapon into his hands even to examine it.
rikto vā eṣo ' yan muṇḍas tasyaetad apidhānaṃ yacśikhāiti /	When someone kills an assailant who is trying to kill him, he commits no sin for then wrath alone confronts wrath so states a Purāṇa .
satreṣu tu vacanād vapanaṃ śikhāyāḥ / ācārye trīn ahorātrān ity eke /	Now, heinous sinners should live in a common settlement and, convinced that this is in keeping with the Law, they should officiate at each others sacrifices, teach each other, and marry each other. When they father sons, they should tell them Go away from us, for then you will be accepted from amongst us as Āryas.When a man falls from his caste, moreover, his virile power does not fall with him, the truth of which ..
śrotriyaabhyāgame ' ' vā/	Dharmasutras can be gathered from the fact that a man lacking a limb fathers a child possessing all the limbs.
vā /	That is false, says Hārīta.
gurusaṃnidhau ca bho ity vā / ubhayata upasaṃgrahaṇam ca /	Sorcery and cursing make a man sordid but do not cause loss of caste. They do cause loss of caste, says Hārīta. People guilty of sins that make them sordid should follow the life prescribed for sins causing loss of caste for twelve months, for twelve fortnights, for twelve times twelve days, for twelve times seven days, for twelve times three days, for twelve days, for seven days, for three days, or for one day.
vā yatraanyo etam eva śabdam utsṛjya /	In this manner sins that make a man sordid should be expiated in accordance with the way the deed was committed . THE BATH AT THE END OF STUDENTSHIPHe should bathe after learning the Vedathat is the view of some likewise after completing the fortyeightyear vow.
śākhāntare ca sāmnām anadhyāyaḥ /	He should bathe after learning the Veda and completing the vow, contend others.
sarveṣu ca śabdakarmasu yatra /	One should behave towards all of these as towards a bathgraduate the specific reward of honouring such a person depends on the degree of his diligence and learning.
svapnaantam /	Observances of a BathGraduate "Next, the observances of a bathgraduate.
sarpir vā /	He should wear clothes that are neither shiny nor, if at all possible, squalid.
pūtīgandhaḥ /	Now, they also quoteHe should eat his food facing the east, void excrement facing the south, discharge urine facing the north, and wash his feet facing the west.
śuktaṃ ca /	a swing is attached.
pradoṣe ca /	He should avoid looking at the sun as it rises or sets.
prodakayoś ca pāṇyoḥ /	During the day the sun protects creatures, and during the night, the moon.
caannaṃ sapradoṣam ahar anadhyāyaḥ /	He should not enter a village along a hazardous path. If he does so, he should softly recite this verse Homage to Rudra, the lord of the dwelling! . or another verse addressed to Rudra. He should not give his leftovers to someone who is not a Brahmin.
ā ca vipākāt /	While he is lying down, moreover, he should refrain from teaching, nor should he teach sitting on the bed in which he sleeps.
aśrāddhena tu /	Teaching .. the Veda is permitted after midnight.
kāṇḍaupākaraṇe caamātṛkasya /	BOOK TWO THE HOUSEHOLDER After marriage, the special observances of the couple living the household life come into force.
kāṇḍasamāpane caapitṛkasya /	On newand fullmoon days, moreover, both should fast.
manuṣyaprakṛtīnāṃ ca devānāṃ yajñe ity eke //	On the following day the man should offer an oblation of cooked food. The procedure for this offering is explained in the section on the newand fullmoon offerings. In the world people require the couple to perform the above rites on every anniversary day. Rites On whatever occasion he is required to place the sacred fire on the altar, he should draw three lines from west to east and three lines from south to north, sprinkle water on them, and kindle the fire.
taṇḍulair āmamāṃsena ca naanadhyāyāḥ /	He should pour out the water used for that towards the north or the east and draw fresh water. Their water vessels should never be emptythis is an observance incumbent on a couple living the household life. Rules of Sexual Intercourse He shall not engage in sex during the daytime. When his wife is in season, he must have sexual intercourse with her as required by his vow.
tathāoṣadhivanaspatimūlaphalaiḥ /	This is similar to the way the seeds of plants and trees, when they are sown on a wellploughed field, increase their fruit. This example explains also the way the fruits of sins increase.
yat kāṇḍam yasya caanuvākyaṃ na tat tad ahar /	Penances for Contact with Outcastes As it is a sin to touch a Cāṇḍāla, so is it to speak to or to look at one.
upākaraṇasamāpanayoś ca pārāyaṇasya tāṃ vidyām /	He may optionally have sex with his wife during her season . In accordance with the vedic precepts, he should be intent on imparting vedic .. knowledge to his pupils and on observing the restrictions. If he acts in this manner, he will bring bliss to his ancestors, to his descendants, and to himself.
vāyur ghoṣavān bhūmau vā tṛṇa saṃvāho vā yatra dhārāḥ ca samadhyayanaṃ tad ahaḥ /	Some say that this should be done by a pair of Śūdras,º one of them being employed in pouring the water. He should have water brought for the guest according to some, in a clay pot. If the guest is a student who has not yet returned home, there is no need to have water brought for him in his case, however, there is the additional requirement to perform the vedic recitation along with him. After addressing the guest with kind words, the host should refresh him with drinks and food, or at a minimum with some water, and offer him a room, a bed, a mattress, a pillow with a cover, and lotion. He should summon his cook and give him rice or barley to ..
svairikarmasu ca /	Vrātya, may you obtain whatever you wish. Vratya, may you obtain whatever you like.
yathā pādaprakṣālanautsādanāanulepanāṇiiti /	If a person has already paid his respects to a guest whom he has provided with accommodation, thereafter he does not have to rise up or get off his couch to greet him. Let him eat what is left over after he has fed his guests.
tāvantaṃ kālaṃ na vā /	He should not consume all the savoury dishes in his house so that there is nothing left for his guests or have exquisite dishes prepared for his own use.
sandhyoḥ /	ANSWER] Experts in exegesis, on the contrary, are in ..
tathā vṛkṣam /	In such a case, the householder should investigate the supplicants qualities and give according to his ability.
apsu ca /	At a Seers marriage, the bridegroom should give a bull and a cow to the brides father.
naktaṃ ca /	Otherwise a husband makes this progeny of his worthless for himself. cf. B .. Va . ..
divā ca	The chariot and the household ..
tasya śākhāantare vākyasamāptiḥ /	For this purpose Manu proclaimed .. Dharmasūtras this rite bearing the name Ancestral Offering he did that also for the prosperity of the people.
atha yadi vāto vā	The specific reward earned by the performer, however, depends on the time that he offers it.
ārdraṃ vā śakṛd oṣadhīr bhūmiṃ vā /	Types of Food The materials used in this rite are sesame and beans, rice and barley, water, roots, and fruits.
hiṃsāarthenaasinā māṃsaṃ	Now, they also quote Feedingoneanother is the name of almsfood given to ghouls.
tathāanutthitāyāṃ sūtikāyām /	The third invitation consists of summoning them. Some assert that everything at an ancestral offering is repeated three times everything is repeated a second and a third time exactly as it was done the first time.
antaḥśave ca /	He addresses them Let me take out some food.
āvasathaṃ	Letting dogs or degraded people look at an ancestral offering is condemned.
māsi māsi	A leper, a bald man, an ..
udīcyavṛttis tv āsanagatānāṃ hasteṣuudapātraānayanam /	An ancestral offering should not be performed after nightfall, and once it is started the performer should not eat until it is completed the only exception being when there is a lunar eclipse. ProhibitionsHe should abstain from the following butter, buttermilk, oilcake, honey, meat, black grain, food given by Sūdras or by others whose food one is forbidden to eat, food unfit for sacrifice, lying, anger, and whatever would provoke someone to anger.
atha parivrājaḥ /	He should keep this vow for a year.
ata eva brahmacaryavān pravrajati /	He should do this for a year. The last of these offerings should be made with the meat of a red goat. He should have a screened altar con .. structed and feed the Brahmins on its northern side.
tasyaupadiśanti /	The fast takes place only at the very beginning.
anagnir aniketaḥ syād aśarmaaśaraṇo muniḥ /	He should be a man who applies himself to acquiring wealth in righteous ways, distributes it to worthy people, gives not to unworthy people if they pose no threat to him, conciliates people, and enjoys pleasures that are not forbidden by the Law.
svādhyāyaevautsṛjamāno vācaṃ grāme prāṇavṛttiṃ pratilabhyaaniho 'anamutraś caret /	With regard to him they admonish He should live as a silent sage, without fire or house, without shelter or protection. Speaking only when he is engaged in private vedic recitation and obtaining food from a village to sustain himself, he should live without any concern for this world or the next.
tasya muktam ācchādanaṃ vihitam /	Discarded clothes are prescribed for him.
sarvataḥ parimokṣam eke /	Some say that he should go completely naked.
satyaanṛte sukhaduḥkhe vedān imaṃ lokam amuṃ ca parityajyaātmānam anvicchet /	Abandoning truth and falsehood, pleasure and pain, the Vedas, this world and the next, he should seek the Self. When he gains insight, he attains bliss.
tatśāstrair vipratiṣiddham /	But that is contradicted by the scriptures.
buddhe cet kṣemaprāpaṇam ihaeva na duḥkham upalabheta /	If a man attains bliss when he gains insight, moreover, he should not feel pain in this very world.
etena paraṃ vyākhyātam /	This clarifies what will be said later on. Forest Hermit Next, the forest hermit.
ata eva brahmacaryavān pravrajati /	From that very state , remaining chaste, he goes forth.
ekaagnir aniketaḥ syād aśarmaaśaraṇo muniḥ / svādhyāya evautsṛjamāno vācam //	With regard to him they admonish He should live as a silent sage with a single fire, but without house, shelter, or protection. Let him speak only when he is engaged in private vedic recitation.
tasyaaraṇyam ācchādanaṃ vihitam /	Clothes made of materials from the wild are prescribed for him.
tato mūlaiḥ phalaiḥ parṇais tṛṇair iti vartayaṃś caret /	Thereafter, he should roam about, living on roots, fruits, leaves, and grasses, and finally on what he happens to find lying about.
tato 'apo vāyum ākāśam ity abhiniśrayet /	After that he should sustain himself on water, air, .. and space.
teṣām uttara uttaraḥ saṃyogaḥ phalato viśiṣṭaḥ /	Among these, each subsequent pursuit is more exceptional in terms of its reward.
atha vānaprasthasyaevaanupūrvyam eke upadiśanti /	Now, some teach an orderly sequence limited to the forest hermit.
vidyāṃ samāpya dāraṃ kṛtvāagnīn ādhāya karmāṇy ārabhate somaavarārdhyāni yāni śrūyante /	After completing his vedic studies, a man should marry a wife, set up the sacred fires, and begin to perform the rites taught in the Vedas, at a minimum the Soma sacrifice.
eko vā / śiloñchena vartayet /	Then he should build a dwelling outside the village and live there either with his wife, children, and sacred fires, or alone.
na caata ūrdhvaṃ pratigṛhṇīyāt / abhiṣiktaś ca juhuyāt /	He should live by gleaning and from that time onwards never accept gifts.
śanair apo 'abhyaveyād abhighnann abhimukham ādityam udakam upaspṛśet /	Only after he has bathed should he offer oblations in the fire. He should enter the water slowly and bathe facing the sun, without splashing.
iti sarvatraudakaupasparśanavidhiḥ /	This procedure of bathing is applicable to Dharmasutras all.
tasya dvaṃdvaṃ dravyāṇām eke upadiśanti pākaarthabhojanaarthavāsiparaśudātrakājānām /	Some say that he should prepare two sets of utensils for cooking and eating, as well as two sets of knives, axes, sickles, and mallets.
dvaṃdvānām ekaekam ādāyaitarāṇi datvāaraṇyam avatiṣṭheta / tasyaaraṇyenaevaata ūrdhvaṃ homo vṛttiḥ pratīkṣātchādanaṃ ca /	He should give one of the two sets, take the other, and set out to the wilderness. From then on he should use only wild produce to offer fire sacrifices, to sustain himself, to attend to guests, and to clothe himself.
yeṣu karmasu puroḍāśāś caravas teṣu kāryāḥ /	He should use rice porridge in rites that call for cakes.
sarvaṃ caupāṃśu saha svādhyāyena / naaraṇyam abhiāśrāvayet /	And he should recite everything, including his private vedic recitation, in an inaudible voice, never permitting wild animals to hear him.
agniarthaṃ śaraṇam / ākāśe svayam / anupastīrṇe śayyāāsane /	He should have a shelter only for his sacred fires, while he himself lives in the open sitting and sleeping on the bare ground. When he has obtained a new stock of grain, he should get rid of the old.
bhūyāṃsaṃ vā niyamam icchann anvaham eva pātreṇa sāyaṃ prātar artham āharet /	Alternatively, if he desires greater severity, he should gather food with his bowl each and every day both in the morning and in the evening.
tato 'apo vāyum ākāśam ity abhiniśrayet teṣām uttara uttaraḥ saṃyogaḥ phalato	Thereafter, he should roam about, living on roots, fruits, leaves, and grasses, and finally on what he happens to find lying about. After that he should sustain himself on water, air, and space. Among these, each subsequent pursuit is more exceptional in terms of its reward.
atha purāṇe ślokāv udāharanti / aṣṭāśītisahasrāṇi ye prajām īśiraṛṣayaḥ /	Superiority among Orders Now, they quote a couple of verses from a Purāṇa The eighty thousand seers who desired offspring went along the suns southern course.
dakṣiṇenaaryamṇaḥ panthānaṃ te śmaśānāni bhejire //	They obtained cremation grounds.
aṣṭāśītisahasrāṇi ye prajāṃ naīṣiraṛṣayaḥ /	The eighty thousand seers who did not desire offspring went along the suns northern course.
athaapi saṃkalpasiddhayo bhavanti /	They, indeed, attained immortality.
yathā varṣaṃ prajādānaṃ dūre darśanaṃ manojavatā yac caanyad evaṃ yuktam /	Such is the praise of those who live celibate lives. And further, these are men who make whatever they want happen by their mere thought, for example, producing rain, bestowing children, seeing what is far away, moving as quickly as thought, and others of this sort.
tasmātśrutitaḥ pratyakṣaphalatvāc ca viśiṣṭān āśramān etān eke bruvate /	Therefore, on the basis of vedic testimony and visible results, some claim that these orders of life are superior.
traividyavṛddhānāṃ tu vedāḥ pramāṇam iti niṣṭhā tatra yāni śrūyante	AUTHORS VIEW] It is the firm view of the most eminent scholars of the triple Veda, however, that the Vedas are the ultimate authority.
vrīhiyavapaśuājyapayaḥkapālapatnīsaṃbandhāny uccair nīcaiḥ kāryam iti tair	The rites using rice, barley, animals, ghee, milk, and potsherds and involving the participation of the wife that are prescribed in the Vedas must be performed with the loud and soft recitation of ritual formulas, they hold, and any practice opposed to those rites is devoid of authority. With regard to the statement about cremation grounds, on the other hand, that passage enjoins the funerary rites at the death of those who have performed many sacrifices.
tataḥ param anantyaṃ phalaṃ svargyaśabdaṃ śrūyate //	Thereafter, the Vedas declare, they obtain an eternal reward designated by the term heaven.
prajām anu prajāyase tad u te martyāmṛtam iti /	The scriptures declare, moreover, that immortality consists of offspring In your offspring you are born again. That, O mortal, is your immortality .
athaapi sa evaayaṃ virūḍhaḥ pṛthak pratyakṣeṇaupalabhyate dṛśyate caapi sārūpyaṃ dehatvam evaanyat /	Furthermore, we can see with our very eyes that the son is a distinct clone of the father himself. One can even see that they are identical, only the bodies are distinct.
te śiṣṭeṣu karmasu vartamānāḥ pūrveṣāṃ sāṃparāyeṇa kīrtiṃ svargaṃ ca vardhayanti /	And the sons, as they continue to perform the prescribed rites, increase the fame and heavenly life of their departed ancestors.
evam avaro 'avaraḥ pareṣām /	Each subsequent generation does the same for those that preceded it.
ā bhūtasaṃplavāt te svargajitaḥ / punaḥ sarge bījaarthā bhavantiiti bhaviṣyatpurāṇe /	They dwell in heaven until the dissolution of creation. At the new creation, they serve as the seed, says the Bhaviṣyat Purāṇa.
athaapi prajāpater vacanam /	And there is also the declaration of Prajāpati ..
trayīṃ vidyāṃ brahmacaryaṃ prajātiṃ śraddhāṃ tapo yajñam anupradānam /	Dharmasutras Study of the triple Veda, studentship, procreation, faith, austerity, sacrifice, giving gifts those who perform these dwell with us.
tatra ye pāpakṛtas ta eva dhvaṃsanti yathā parṇaṃ vanaspater na parān hiṃsanti /	Anyone who praises other things becomes dust and perishes. If any of the children commit sins, they alone perish, like the leaf of a tree. They do not harm their ancestors.
naasyaasmiṃl loke karmabhiḥ saṃbandho vidyate tathā parasmin karmaphalaiḥ /	As in this world a parent is not tied to the actions of his children, so in the next world he is not tied to the results of their actions.
tad etena veditavyam /	This principle is illustrated by the following fact.
prajāpater ṛṣīṇām iti sargo 'ayam /	This creation is the work of Prajapati and the seers.
tatra ye puṇyakṛtas teṣāṃ prakṛtayaḥ parā jvalantya upalabhyante / syāt tu karmaavayavena tapasā vā kaścit saśarīro 'antavantaṃ lokaṃ jayati saṃkalpasiddhiś ca syān na tu taj jyaiṣṭhyam āśramāṇām	We see the bodies of those seers who have done meritorious deeds shining brilliantly far above. It may well be that someone, through a portion of his accumulated merits or by means of austerity, attains a limited world together with his body and even makes what he wants happen by his mere thought. But that is no reason to make one order of life superior to another.
vyākhyātāḥ sarvavarṇānāṃ sādhāraṇavaiśeṣikā dharmāḥ /	KING We have explained the general and specific Laws of all the classes.
rājñas tu viśeṣād vakṣyāmaḥ /	We will now present specifically the Laws pertaining to a king.
dakṣiṇādvāraṃ veśma puraṃ ca māpayet /	Royal Fort He should have a residence and a fort constructed, with their gates facing the south.
tasya purastād āvasathas tad āmantraṇam ity ācakṣate /	The residence is within the fort, and in front of the residence is the lodge, which is known as the Audience Hall.
dakṣiṇena puraṃ sabhā dakṣiṇaudagdvārā yathāubhayaṃ saṃdṛśyeta bahir antaraṃ caiti /	To the south of the fort is the assembly hall with doors on both the south and the north sides so that one can see what goes on within and without.
agnipūjā ca nityā yathā gṛhamedhe /	Duties In every one of these buildings fires should be kept burning continuously, and every day offerings should be made in these fires in the same manner as at the domestic ritual.
āvasathe śrotriyaavarārdhyān atithīn vāsayet /	The king should put up in the lodge at least those guests who are vedic scholars.
teṣāṃ yathāguṇam āvasathāḥ śayyaānnapānaṃ ca videyam /	They should be given accommodation, as well as beds, food, and drink, in accordance with their distinction.
gurūn amātyāṃś ca naatijīvet /	The king should not live more opulently than his elders and ministers.
na caasya viṣaye kṣudhā rogeṇa himaātapābhyāṃ vāavasīded abhāvād buddhipūrvaṃ vā kaścit /	And in his realm no one should suffer from hunger, illness, cold, or heat, either through want or by design.
sabhāyā madhye 'adhidevanam uddhatyaavokṣyaakṣān nivaped yugmān vaibhītakān yathāarthān /	Gambling In the middle of the assembly hall he should erect a gaming table, sprinkle it with water, and place there dicethey should be in pairs, of Vibhītaka seeds, and in adequate numbers.
āryāḥ śucayaḥ satyaśīlā dīvitāraḥ syuḥ /	ryas who are upright and honest may gamble there.
āyudhagrahaṇaṃ nṛttagītavāditrāṇiiti rājaadhīnebhyo 'anyatra na vidyeran / kṣemakṛd rājā yasya viṣaye grāme 'araṇye vā taskarabhayaṃ na vidyate //	Weapons contests, dancing, singing, and concerts should not be held without the presence of royal officials. Protection of Subjects A king provides protection only when there is no fear of thieves in the villages or wild tracts of his realm.
bhṛtyānām anuparodhena kṣetraṃ vittaṃ ca dadad brāhmaṇebhyo yathāarham anantāṃl lokān abhijayati /	If he gives land and wealth to Brahmins according to their worth without depriving his own dependants, he will win eternal worlds.
brāhmaṇasvāny apajigīṣamāṇo rājā yo hanyate tam āhur ātmayūpo yajño 'anantadakṣiṇa iti /	When a king is killed attempting to recover property stolen from Brahmins, they call it a sacrifice at which his own body serves as the sacrificial post and an unlimited amount is given as the sacrificial fee.
etenaanye śūrā vyākhyātāḥ prayojane yudhyamānās tanutyajaḥ /	This explanation covers also other heroes who sacrifice their lives fighting for a just cause.
grāmeṣu nagareṣu caāryānśucīn satyaśīlān prajāguptaye nidadhyāt /	Appointment of Security Officers To protect his subjects he should appoint over villages and towns Āryas who are upright and honest.
teṣāṃ puruṣās tathāguṇā eva syuḥ /	Their subordinates should also be men possessing the very same qualities.
sarvato yojanaṃ nagaraṃ taskarebhyo rakṣyam / krośo grāmebhyaḥ / tatra yatmuṣyate tais tat pratidāpyam /	They must protect a town from thieves up to nine miles on all sides, and a village up to a couple of miles. They must be forced to make good anything that is stolen within those limits.
dhārmyaṃ śulkam avahārayet /	Dharmasutras Collection of Taxes The king should get them to collect lawful taxes.
ye ca vidyāarthā vasanti / tapasvinaś ca ye dharmaparāḥ / śūdraś ca pādaavanektā / andhamūkabadhirarogaviṣṭāś ca	The following persons are exempt from taxes vedic scholars, women of all classes, prepubescent boys, those who are living in someones house for the purpose of study, ascetics devoted to the Law, Śūdras who are personal servants, people who are blind, dumb, deaf, and sick, and those who are excluded from acquiring property.
abuddhipūrvam alaṃkṛto yuvā paradāram anupraviśan kumārīṃ vā vācā bādhyaḥ /	Sexual Misconduct Rape If a young man all primped up barges accidentally into the presence of another mans wife or a young woman, he should be verbally reprimanded but if he does so deliberately and with a malicious intent, he should be punished.
saṃnipāte vṛtte śiśnacchedanaṃ savṛṣaṇasya /	If intercourse took place, his penis should be cut off along with the testicles.
kumāryāṃ tu svāny ādāya nāśyaḥ /	If it was with a young woman, he should be banished and his property confiscated.
atha bhṛtye rājñā /	Thereafter, the king should support those women and from then onwards guard them from sexual congress.
nirveṣaabhyupāye tu svāmibhyo 'avasṛjet //	If they agree to perform the expiation, however, he should hand them over to their respective guardians.
carite yathāpuraṃ dharmādhi saṃbandhaḥ /	Once the expiation has been performed, the guardians should treat them as before, for their relationship is based on the Law.
sagotrasthānīyāṃ na parebhyaḥ samācakṣīta / kulāya hi strī pradīyata ity upadiśanti /	Levirate A man should not introduce to an outsider the woman who has assumed his lineage , for a wife is given to the family so they admonish.
tad indriyadaurbalyād vipratipannam /	That is now forbidden because of the weakness of the flesh, for with respect to the husband all are equally outsiders.
tadvyatikrame khalu punar ubhayor narakaḥ / niyamaārambhaṇo hi varṣīyān abhyudaya evam ārambhaṇād apatyāt /	When this is violated, both husband and wife will undoubtedly end up in hell, for the happiness resulting from following this restriction is far greater than that resulting from children obtained by following that custom.
vadhyaḥ śūdra āryāyām /	Adultery An Arya who has sex with a Śūdra woman should be banished, while a Śūdra who has sex with an Ārya woman should be executed, and that wife of his should be emaciated.
savarṇāyām anyapūrvāyāṃ sakṛt saṃnipāte pādaḥ patatiity upadiśanti / evam abhyāse pādaḥ pādaḥ /	If a man has sex once with a married woman of his own class, they say, the punishment is onequarter of what is prescribed for one fallen from his caste.
caturthe sarvam /	Each time he repeats it, likewise, onequarter is added, and the fourth time he gets the full punishment.
jihvāācchedanaṃ śūdrasyaāryaṃ dhārmikam ākrośataḥ /	Crime and Punishment If a Śūdra hurls abusive words at a virtuous Ārya, his tongue shall be cut out.
vāci pathi śayyāyām āsana iti samībhavato daṇḍatāḍanam /	If, while he is speaking, walking on the road, lying in bed, or occupying a seat, a Śūdra pretends to be equal to Āryas, he should be flogged.
puruṣavadhe steye bhūmiādāna iti svāny ādāya vadhyaḥ /	If a Sūdra kills a man, steals, or appropriates land, he should be executed and his property confiscated.
cakṣunirodhas tv eteṣu brāhmaṇasya / niyamaatikramaṇam anyaṃ vā rahasi bandhayet /	If a Brahmin is guilty of these crimes, however, he should be blindfolded. Alternatively, those who transgress their specific duties should be kept in secret confinement until they relent.
asamāpattau nāśyaḥ /	If they do not relent, they should be banished.
ācārya ṛtvik snātako rājāiti trāṇaṃ syur anyatra vadhyāt //	A teacher, an officiating priest, a bathgraduate, and the king may save him from punishment, except in the case of a capital crime.
kṣetraṃ parigṛhyautthānābhāvāt phalābhāve yaḥ samṛddhaḥ sa bhāvi tad apahāryaḥ / avaśinaḥ kīnāśasya karmanyāse daṇḍatāḍanam /	If someone takes a piece of land on lease and it produces no harvest because he puts no effort into it, then, if he has the means, he should be made to pay the landowner what would have been his due. An indentured farmhand who quits working should be flogged so also a herdsman, and his flock should be impounded.
hitvā vrajam ādinaḥ karśayet paśūn naatipātayet /	If cattle escape from the corral and begin to eat the crops, one may emaciate them but not abuse them.
avarudhya paśūn māraṇe nāśane vā svāmibhyo 'avasṛjet /	If someone takes charge of cattle and lets them die or become lost, he should pay restitution to the owners.
pramādād araṇye paśūn utsṛṣtān dṛṣṭvā grāmam ānīya svāmibhyo 'avasṛjet /	If someone sees cattle that have been carelessly allowed to wander into the wilderness, he should bring them to the village and return them to their owners.
punaḥ pramāde sakṛd avarudhya / tata ūrdhvaṃ na sūrkṣet /	If such negligence happens again, he should return them after first impounding them, and thereafter he should ignore them.
paraparigraham avidvān ādadāna edhaudake mūle puṣpe phale gandhe grāse śāka iti vācā bādhyaḥ /	If someone unknowingly takes the property of another, such as fuel, water, roots, flowers, fruits, perfume, fodder, or vegetables, he should be verbally reprimanded. If he does so ..
viduṣo vāsasaḥ parimoṣaṇam /	Dharmasutras knowingly, his clothes should be taken away.
adaṇḍyaḥ kāmakṛte tathā prāṇasaṃśaye bhojanam ādadānaḥ /	Even if it is done intentionally, no one should be punished for taking food to save his life.
prāptanimitte daṇḍaakarmaṇi rājānam enaḥ spṛśati //	If the king fails to inflict punishment when it is called for, the sin recoils upon him.
prayojayitā mantā kartāiti svarganarakaphaleṣu karmasu bhāginaḥ / yo bhūya ārabhate tasmin phalaviśeṣaḥ /	Those who direct, those who consent, and those who carry out an act share in its fruit, whether it is heaven or hell, but those who are more closely involved with the act receive a larger share of the fruit.
kuṭumbinau dhanasyaīśate /	Marital Property The husband and wife have joint control over their property.
tayor anumate 'anye 'api tadhiteṣu varteran /	With their consent and for their benefit, others also may tend to it.
vivāde vidyāabhijanasaṃpannā vṛddhā medhāvino dharmeṣv avinipātinaḥ /	Judicial Process Men who are learned, of good family, elderly, wise, and unwavering in their duties shall adjudicate lawsuits, in doubtful cases investigating the matter by examining the evidence and using ordeals.
puṇyāhe prātar agnāv iddhe 'apāmante rājavaty ubhayataḥ samākhyāpya sarvaanumate mukhyaḥ satyaṃ praśnaṃ brūyāt /	Witnesses In the morning of an auspicious day and in the presence of a blazing fire, water, and the king, both sides should be asked to present their case and, with everyones approval, the chief witness should answer the questions truthfully.
anṛte rājā daṇḍaṃ praṇayet / narakaś caatraadhikaḥ sāṃparāye /	Should he answer untruthfully, the king should punish him and in addition hell awaits him after death.
satye svargaḥ sarvabhūtapraśaṃsā ca /	Should he answer truthfully, he will go to heaven and all beings will sing his praises.
sā niṣṭhā yā vidyā strīṣu śūdreṣu ca / ātharvaṇasya vedasya śeṣa ity upadiśanti /	CONCLUSION OF THE STUDY OF LAW The knowledge found among women and Śūdras forms the conclusion, and they point out that it is a subsidiary component of the Atharva Veda.
kṛcchrā dharmasamāptiḥ samāmnātena /	It is difficult to gain mastery of the Law by means of scriptures alone, but by acting according to the markers one can master it.
tatra lakṣaṇam / sarvajanapadeṣv ekāntasamāhitam āryāṇāṃ vṛttaṃ samyagvinītānāṃ vṛddhānām ātmavatām alolupānām adāmbhikānāṃ vṛttasādṛśyaṃ bhajeta /	And the markers in this case are as follows he should model his conduct after that which is unanimously approved in all regions by Aryas who have been properly trained, who are elderly and selfpossessed, and who are neither greedy nor deceitful.
evam ubhau lokāv abhijayati /	In this way he will win both worlds .
strībhyaḥ sarvavarṇebhyaś ca dharmaśeṣān pratīyād ity eke ity eke //	According to some, one should learn the remaining Laws from women and people of all classes.
//samāptaṃ caidam āpastambīyadharmasūtram //	That concludes the Apastamba Dharmasūtra.
