input_text	target_text
nanaggacariyā najaṭānapaṃko nānāśanaṃtthaṇḍīlaśāyikā vā|	Neither going naked, nor matted hair, nor mud, nor fasting or lying on stony ground,
rajocelaṃ ukkuṭukapradhānaṃ śodhenti māccaṃ avitiṇṇakaṃchaṃ ||	dusty clothes, or striving while squatting, can purify a mortal who has not removed uncertainty.
alaṃkato cāpi samaṃ careyā dānto śānto niyato dhammacārī |	Even if he were to adorn himself, but is trained, peaceful, settled, living by Dhamma,
sabbesu prāṇesu nidhāya daṇḍaṃ so brāhmaṇo so śamaṇo sa bhikkhū ||	and has put aside the stick towards all living beings, he is a brahmin, an ascetic, a monastic.
mā vade paruṣaṃ kaṃci vuttā paṭivadeyu taṃ |	Do not speak anything harsh, spoken to they might answer back to you,
dukkhā hi sārambhakathā paṭidaṇḍā phuseyu taṃ ||	for arrogant talk entails misery, and they might strike you back with a stick.
sace iresi āttānaṃ kaṃso upahato-r-iva |	If you make a sound like a gong that is struck,
jātimaraṇasaṃsāraṃ ciraṃ praccanubhohisi ||	you will undergo the rounds of births and deaths for a long time.
na ce iresi āttānaṃ kaṃso anupahato-r-iva |	If you make no sound like a gong that is not struck,
esa prātto si nibbāṇaṃ sārambhā te na vijjati ||	you are like one who has attained Nibbāna, contention is not found in you.
yathā daṇḍena gopālo gāvo pājeti gocaraṃ |	Like a cowherd with a stick drives cattle to pasture,
evaṃ jarā ca maccū ca prāṇināṃ adhivattati ||	so do old age and death overpower living beings.
yathā daṇḍena gopālo gāvo rakṣati sāmināṃ |	Like a cowherd with a stick protects the owner’s cattle,
evaṃ rakkhatha āttānaṃ khaṇo vo mā upaccagū |	so one should watch over oneself, and you should not let the moment pass,
khaṇātītā hi śocanti nirayamhi samappitā ||	for when the chance has passed they grieve when consigned to the underworld.
sabbe trasanti daṇḍānāṃ sabbesaṃ jīvitaṃ priyaṃ |	Everyone trembles at sticks, for all of them life is dear,
āttānaṃ upamaṃ kattā neva haṃyyā na ghātaye ||	comparing oneself with others, one should not hurt or have them hurt.
sukhakāmāni bhūtāni yo daṇḍena vihiṃsati |	One who harms with a stick beings who desire happiness,
āttano sukham eṣāṇo precca so na labhate sukhaṃ ||	while seeking happiness for himself, won’t find happiness after death.
sukhakāmāni bhūtāni yo daṇḍena na vihiṃsati |	One who harms not with a stick beings who desire happiness,
āttano sukham eṣāṇo precca so labhate sukhaṃ ||	while seeking happiness for himself, will find happiness after death.
na bhajetha pāpake mitre na bhajetha puruṣā ’dhame |	One should not keep company with wicked friends, one should not keep company with the ignoble,
bhajetha praṃñe medhāvī bhajetha puruṣottame |	you should keep company with the sage and wise, you should keep company with superior people.
tārise bhajamānassa śreyo hoti na pāpiyo ||	keeping company with such is surely better for you, not worse.
nidhino va pravattāraṃ yaṃ paśśe vajjadaṃśinaṃ |	One should regard someone who shows your faults just like one who points out hidden treasure,
nigṛhyavādiṃ medhāvīṃ tārisaṃ puruṣaṃ bhaje |	one should keep company with such a sagacious person who reproves you;
ovadeyā anuśāseyā asabbhāto nivāraye |	One should advise and instruct, and forbid whatever is vile,
satāṃ hetaṃ priyaṃ hoti asatāṃ hoti apriyaṃ ||	for this is dear to the good, but it is not dear to the bad.
tassā satāñ ca asatāñ ca nānā hoti ito gatī |	Therefore the good and the bad from here go to various destinies,
asanto nirayaṃ yānti santo saggaparāyaṇā ||	the bad go to the underworld, the good cross over to heaven.
appaśśuto ayaṃ puruṣo balivaddo va jīrati |	The person of little learning increases in age like an ox,
māṃsāni tassa vaddhanti praṃñā tassa na vaddhati ||	for although his flesh does increase, his wisdom does not increase.
cattāri ṭṭhānāni naro pramatto āpajjate paradāropasevī |	There are four states the man who is heedless, the man who consorts with other man’s wives, undergoes:
apuṃñalābhaṃ anikāmaśeyaṃ nindaṃ tritīyaṃ nirayaṃ catutthaṃ ||	he gains demerit, an uncomfortable bed, blame as third, and rebirth in the underworld as fourth.
apuṃñalābho ca gatī ca pāpiko bhītassa bhītāya ratī pi appikā |	Gaining demerit and a bad destiny, and only the little delight of a scared man with a scared woman,
rājā ca daṇḍaṃ garukaṃ praṇeti kāyassa bhedā nirayaṃ upeti ||	and kings who apply heavy punishment, at the break up of the body he goes to the underworld.
saṃyyatā sugatiṃ yānti doggatiṃ yānti asaṃyyatā |	The restrained go to a good destiny, the unrestrained go to a bad destiny,
mā ssu viśśāsam āpādi iti vindu samaṃ care ||	thinking: “I should not exhibit confidence,” the wise one wanders peacefully.
mā kuñjara nāgam āsida dukkho kuñjara nāgamaṃsado |	Do not, elephant, approach the Buddha, for there is suffering, elephant, in approaching the Buddha,
na hi nāgahatassa kuñjara sugatī hoti ito paraṃ yato ||	for the one who attacks the Buddha, elephant, does not go from here to a good destiny.
giriduggavicāriṇaṃ yathā sīhaṃ parvvatapaṭṭhigocaraṃ |	As a lion wanders his mountain fortress, his resort on the mountainside,
naravīram apetabheravaṃ mā hiṃsittha anomanikramaṃ ||	do not hurt the man-hero, the one without fear, the one of superior effort.
ahaṃ nāgo va saṃggrāme cāpātipatite sare |	Like an elephant in battle endures arrows shot from bow
atīvāde titikkhāmi duśśīlo hi bahujano ||	so will I endure abuse, for many people are unvirtuous.
daṇḍavarggaḥ	The Chapter about the Stick
abhittaretha kallāṇe pāpā cittaṃnivāraye|	Hasten to do wholesome deeds, ward off the mind from wickedness,
daṃdhaṃhikaratopuṃñaṃ pāpamhi ramatemano ||	for the mind of the one slow in merit delights in wickedness.
kayira ce puruṣo pāpaṃ na naṃ kayirā punappuno |	Should a person do that which is wicked, he should not do it again and again,
na tamhi chandaṃ kayirātha dukkho pāpassa saṃcayo ||	let him not place his intention in it, for there is an accumulation of suffering for the wicked one.
kayira ce puruṣo puṃñaṃ kayira cenaṃ punappuno |	If a person should make merit, he should do it again and again,
tamhi eva chandaṃ kayirātha sukho puṃñassa saṃcayo ||	let him place his intention there, there is an increase of joy for the one who has made merit.
śuddhasseva sadā phaggū suddasso ’poṣatho sadā |	For the pure one there is always fasting, for the pure one there is always the fast day,
śuddhassa śucikammassa sadā saṃpajjate vrataṃ ||	for the pure one, the one of clean deeds, his vow always succeeds.
akataṃ dukkataṃ śreyo pacchā tapati dukkataṃ |	Better undone is a wrong-doing, a wrong-doing one later regrets,
dukkataṃ me kataṃ ti śocati bhūyo śocati doggatiṃ gato ||	he grieves, thinking: “I have done a bad deed,” gone to a bad fate, he grieves much more.
katañ ca sukataṃ sādhu yaṃ kattā nānutappati |	Better done is what is well-done, which, when done, one does not regret
sukataṃ me kataṃ ti nandati bhūyo nandati soggatiṅ gato ||	he is happy, thinking: “I have done a good deed,” gone to a good fate, he is happy much more.
pāpo pi paśśate bhadraṃ yāva pāpaṃ na paccati |	Even the wicked one experiences good fortune while the wickedness does not ripen,
yadā tu paccate pāpaṃ atha pāpo pāpāni paśśati ||	but when the wickedness ripens then the wicked one experiences wicked things.
bhadro pi paśśate pāpaṃ yāva bhadraṃ na paccati |	Even the fortunate one experiences wickedness as long as the good fortune does not ripen,
yadā tu paccate bhadraṃ atha bhadro bhadrāṇi paśśati ||	but when the fortune ripens then the fortunate one experiences good fortune.
pāpaṃ pi karato bhadraṃ yāva pāpaṃ na paccati |	Even the wicked one does good while the wickedness does not ripen,
atha payirāgate kāle pāpo pāpāni paśśati ||	but when the time has gone by the wicked one experiences wicked things.
bhadraṃ pi karato pāpaṃ yāva bhadraṃ na paccati |	Even the fortunate one does wickedness as long as the good fortune does not ripen,
atha payirāgate kāle bhadro bhadrāṇi paśśati ||	but when the time has gone by the fortunate one experiences good fortune.
pāṇimhi ce vraṇo nā ’ssa dhāreyā pāṇinā viṣaṃ |	If there is no wound for him in his hand he can carry poison with his hand,
nāvraṇe viṣam anneti nāsti pāpaṃ akurvvato ||	poison does not enter without a wound, there is no wickedness for the one who does not do wrong.
na hi pāpakaṃ kataṃ kammaṃ sajjaṃ chīraṃ va mucchati |	A wicked deed that has been done, like milk, does not turn all at once,
dahantaṃ bālam anneti bhassachanno va pāpako ||	smouldering, it follows the fool, like a fire covered with ashes.
na hi pāpakaṃ kataṃ kammaṃ sajjaṃ śastam va kantati |	A wicked deed that has been done, like a knife, does not cut all at once,
maraṇo ’peto hi jānāti yā gatī pāpakaṃmuṇo ||	but when death comes he knows the destiny of those who do wickedness.
anāgataṃ paṭikayirātha kiccaṃ mā vo kiccaṃ kiccakāle vyadheyā |	You should prepare beforehand what is to be done, do not tremble at what is to be done at the time for it,
taṃ tārisaṃ paṭikatakiccakāriṃ na naṃ kiccaṃ kiccakāle vyadheti ||	for such a one who has prepared what is to be done, does not tremble at what is to be done at the time for it.
paṭikacceva taṃ kayirā yaṃ ñāyyā hitam āttano |	One should prepare to do that which one knows is for one’s welfare,
na śākaṭikamanti ssa mantaṃ dhīro parākrame ||	the sage, the wise one should make effort, not with the thinking of the charioteer.
yathā śākaṭiko māggaṃ samaṃ hettā mahāpathaṃ |	As the charioteer who abandoned the smooth path of the highway,
viṣamaṃ māggam āsājja akkhachinno tha jhāyati ||	and approached the rough path, then he broods, as upon a broken axle,
evaṃ dhammā apakrāṃma adhaṃmam anuvattiya |	so the one departing from Dhamma and following what is not Dhamma,
bālo maccumukhaṃ prātto akkhachinno va jhāyati ||	when that fool comes to Death’s jaws he broods, as upon a broken axle.
kāṣāyakaṃṭhā bahavo pāpadhaṃmā asaṃyyatā |	Many wearing the monastic robe around their necks are wicked, unrestrained.
pāpā pāpehi kaṃmehi nirayaṃ te upapajjatha ||	Wicked ones! Through your wicked deeds, you re-arise in the underworld.
abhūtavādī nirayaṃ upeti yo cāpi kattā na karomī ti āha |	One who speaks what is untrue goes to the underworld, he who says: ‘I do not do’ what he has done,
ubho pi te precca samā bhavanti nihīnakaṃmā manujā paratra ||	both of these are just the same when they have gone to the hereafter, they are humans who did base deeds.
yo apraduṣṭassa naro praduṣyati śuddhassa poṣassa anaṃgaṇassa |	He who offends against the inoffensive one, a purified and passionless person:
tam eva bālaṃ pracceti pāpaṃ sukhumo rajo paṭivātaṃ va khitto ||	that wicked deed then returns to the fool, like fine dust that is thrown against the wind.
vāṇijo va bhayaṃ māggaṃ appasāttho mahaddhano |	Like a merchant on a fearful path, with few friends and great wealth,
viṣaṃ jīvitukāmo va pāpāni parivajjaye ||	as one loving life would avoid poison, so should one avoid wicked deeds.
paradukkhopadhānena yo icche sukham āttano |	He who desires happiness for himself by causing suffering for another,
verasaṃsaggasaṃsaṭṭho dukkhā na parimuccati ||	being associated thus with hatred, is not fully released from suffering.
kuṇapassa pi gandhucchijjati u ’ddhukitassa pi rāti accayā |	The smell of a corpse is cut off eventually, also of one bloated when nights have passed,
puruṣassa adhammacāriṇo annāhaṃ gandho na chijjati ||	but of the man who lives not by Dhamma day by day his smell is never cut off.
yatha ggrahapatayo prabhūtaratanā āḍitte nagaramhi dahyamāne |	Just as householders having great treasures, when the city is on fire and burning,
muttāmaṇiphaṭikarajataheto vyāyamanti api nīharema kiṃci ||	because of their pearls, jewels, crystal and silver, make effort, thinking: “We will save something”,
tatha-r-iva śamaṇā prabhūtapraṃñā ayirā ayirapathesu sicchamānā |	so the ascetics of great wisdom, noble ones training along the noble path,
jātijarāmaraṇabhayāddittā dukkhāṭṭā vyāyamanti api prāpuṇema śāntiṃ ||	oppressed with the fear of birth, old age, death, afflicted by suffering, make effort, thinking: “We will attain peace”.
kalyāṇīvarggaḥ	The Chapter about the Wholesome
vācānurakkhī manasā susaṃvṛto kāyena yo akuśalaṃ na sevati|	Verbally guarded, well-restrained in mind, he who does not practice a wrong deed with the body,
etettayo kaṃmapathe viśodhiya prāppojja so śāntipadaṃ anuttaraṃ ||	purifying these three paths of action, would attain the unsurpassed state of peace.
kāyapradoṣaṃ rakkheyā kāyena saṃvṛto siyā |	One should guard against bodily faults, one should be restrained bodily,
kāyaduccaritaṃ hettā kāyena sucaritaṃ care ||	abandoning wrong bodily conduct, one should have good bodily conduct.
vācāpradoṣaṃ rakkheyā vācāya saṃvṛto siyā |	One should guard against verbal faults, one should be restrained verbally,
vācāduccaritaṃ hettā vācāya sucaritaṃ care ||	abandoning wrong verbal conduct, one should have good verbal conduct.
manapradoṣaṃ rakkheyā manasā saṃvṛto siyā |	One should guard against mental faults, one should be restrained mentally,
manoduccaritaṃ hettā manasā sucaritaṃ care ||	abandoning wrong mental conduct, one should have good mental conduct.
kāyena saṃvṛtā dhīrā vācāya utta cetasā |	The wise are restrained bodily, verbally and also mentally,
sabbattha saṃvṛtā dhīrā te ve suparisaṃvṛtā ||	the wise are restrained in every way, they are indeed very well-restrained.
porāṇam etaṃ ādhora na etaṃ ahunā-r-iva |	This is something of old, Ādhora, this is not something of today:
nindanti tohnim āsīnaṃ nindanti mitabhāṇikaṃ |	they blame the one who sits silently, they blame the one who talks in moderation,
bahubhāṇikaṃ pi nindanti nāsti loke anindito ||	they blame the one who talks a lot, there is no one in the world not blamed.
na cābhu na ca bhaviṣyati na cetarahi vijjati |	There was not and there will not be, and at present there is not found
ekāntanindito poṣo ekāntaṃ vā praśaṃsito ||	a person totally blameworthy, or one totally praiseworthy.
yañ ca bālā adhaṃmaṭṭhaṃ pūjeyu garaheyu vā |	He who would worship or reproach the one who is unrighteous,
aviñūṃ avibhāvāya na taṃ atthāya kāyaci ||	a fool with lack of intelligence, that is to no purpose.
yaṃ ca viñū praśaṃsanti anuvicca suve suve |	The one who, after being examined day by day, is praised by the wise,
acchidravattiṃ medhāviṃ praṃñāśīlasamāhitaṃ ||	faultless in conduct, sagacious, attending to virtue and wisdom,
nikkhaṃ jāṃbūnadasseva ko taṃ ninditum arihati |	one who is like a golden coin, who is there worthy to blame him?
devā pi naṃ praśansanti brahmuṇā pi praśaṃsito ||	That one is praised by the gods, and has been praised by the Brahmās too.
na vākkaraṇamātteṇa vannapukkhalatāya vā |	Not by eloquence only, or by a beautiful complexion,
sādhurūpī naro hoti iśśukī maccharī śaṭho ||	is a person honourable, if still jealous, selfish and deceitful.
yamhi saccaṃ ca dhammo ca viratī saṃyyamo damo |	In whom is truth, Dhamma, abstinence, restraint and good training,
sa vāntadoṣo medhāvī sādhurūpī ti vuccati ||	that sage who has thrown out hatred is said to be honourable.
bahuṃ pi ce sahitaṃ bhāṣamāno na takkaro hoti naro pramatto |	Even though reciting abundant scriptures, the heedless fellow, who does not do what they say,
gopo va gāvo gaṇayaṃ paresaṃ na bhāgavā śāmaṇṇassa hoti ||	like a cowboy counting other’s cattle, does not partake of the ascetic life.
appaṃ pi ce sahitaṃ bhāṣamāno dhammassa hoti anudhammacārī |	Even though reciting but few scriptures, but living righteously in accordance with Dhamma,
rāgaṃ ca doṣaṃ ca prahāya mohaṃ vimuttacitto akhilo akaṃcho |	abandoning greed, hate and delusion, with mind released, completely without doubt,
anupādiyāno iha vā hure vā sa bhāgavā śāmannassa hoti ||	that one, unattached here and hereafter, surely partakes of the ascetic life.
saccaṃ bhaṇe na kujjheyā deyā appā pi yācito |	One should speak out the truth, one should not get angry, when requested you should give, if only a little,
etehi ttihi ṭṭhāṇehi gacche devāna santike ||	through these three conditions one can go to the presence of the gods.
na ve kadāryyā devalokaṃ vrajanti bālā hi bhe na praśaṃsanti dānaṃ |	The miserly go not to the world of the gods, fools surely do not praise giving,
dhīro tu dānaṃ anumodamāno teneva so devalokaṃ pareti ||	but the wise one rejoices in giving, and through that he goes to the world of the gods.
śīlavantaṃ śuciṃ dacchaṃ dhammaṭṭhaṃ saccavādinaṃ |	Having virtue, being pure and clever, principled, knowing the truths,
āttano kārakaṃ śantaṃ taṃ jano kurute priyaṃ ||	the good one doing the deeds that are his own, that one the people love.
śreyo ayoguḍā bhuttā tattā aggiśikhopamā |	It’s better to have eaten glowing iron balls, like flames of fire,
yaṃ ca bhuñjeya duśśīlo rāṣṭapiṇḍaṃ asaṃyyato ||	than that the monastic who is unrestrained and unvirtuous should enjoy the country’s almsfood.
kuśo yathā duggṛhīto hastam evānukaṃtati |	As kusa grass, wrongly grasped, cuts into the hand,
śāmannaṃ dupparāmāṭṭhaṃ nirayāya upakaṭṭati ||	so does the ascetic life, wrongly grasped, drag one down to the underworld.
ekadhaṃmam atītassa muṣāvādissa jaṃtuno |	For the person speaking falsely, who has transgressed in this one thing,
vitinnaparalokassa nāsti pāpaṃ akāriyaṃ ||	who has abandoned the next world, there is no wickedness left undone.
na hi śastaṃ suniśitaṃ viṣaṃ hālāhalaṃ tathā |	For not a well-sharpened sword, or even deadly poison,
evaṃ khipraṃ atipāteti vācā dubbhāṣitā yathā ||	destroy quite as quickly as words that are badly spoken.
puruṣassa jāyamānassa kuṭhārī jāyate mukhe |	For with the birth of a man an axe is born in his mouth,
yāya chindati āttānaṃ vācaṃ dubbhāṣitaṃ bhaṇaṃ ||	with which he cuts himself speaking a word that is badly spoken.
yo hi nindiye praśaṃsati uttavā nindati yo praśaṃsiye |	He who praises the blameworthy, or he who blames the praiseworthy,
vicināti mukhena so kaliṃ kalinā tena sukhaṃ na vindati ||	piles up bad fortune with his mouth, and because of that bad fortune he does not find happiness.
appāmātto ayaṃ kalī yo akkhehi dhanaṃ parājaye |	(Compared to) he who has a small measure of bad fortune through dice and loses his wealth,
sabbassaṃ pi sahāpi āttanā	everything (he owns), together with his self;
ayam eva mahataro kalī yo sugatesu manaṃ pradūṣaye ||	this is indeed a far greater bad fortune: he who has a corrupt mind aimed at those faring well.
śataṃ sahasrāṇi nirabbudānāṃ chattrīśatiṃ paṃca ca abbudāni |	For one hundred and thirty-six thousand nirabbudas, and five abbudas,
yaṃ ayiragarahī nirayaṃ upeti vācaṃ manaṃ ca praṇidhāya pāpikāṃ ||	he goes to hell through reproaching the noble ones, having wicked verbal and mental intentions.
kallāṇim eva bhāṣeyā na ’ssa mucceya pāpikā |	He should speak wholesomely, he should not speak wickedly,
mokkho kallāṇiye śreyo muttā tapati pāpikāṃ ||	the speaking of what is wholesome is best, having spoken wickedly he suffers.
kallāṇim eva seveyā na ’ssa mucceya pāpikā |	He should practice wholesomely, he should not speak wickedly,
vācaṃ bhāṣeyā kallāṇiṃ na ’ssa mucceya pāpikā |	He should speak wholesome words, he should not speak wickedly,
jātaṃ krodhaṃ nivāreyā so biṣabbhi nirujjhati ||	arisen anger he should constrain, he ceases from hatred.
vācāvarggaḥ	The Chapter about Verbalising
3. brāhmaṇa	3. The Chapter about Brahmins
chinna sūtraṃ parākrāmma bhavaṃ praṇuda brāhmaṇa |	Strive and cut off the thread, remove continuity, brahmin,
saṃkhārāṇāṃ khayaṃ ñāttā akathaso si brāhmaṇa ||	knowing the destruction of the conditioned, you are … brahmin
yamhi dhammaṃ vijāneyā vṛddhamhi daharamhi vā |	That one from whom one learned Dhamma, whether old or young,
sakkacca naṃ namasseyā aggihotraṃ va brāhmaṇo ||	with respect bow down to him, like a brahmin bows at fire-sacrifice.
yamhi dhammaṃ vijāneyā sammasaṃbuddhadeśitaṃ |	That one from whom one learned Dhamma taught by the Perfect Sambuddha,
tam eva apacāyeyā aggihotraṃ va brāhmaṇo ||	you should honor him, like a brahmin honors the fire-sacrifice.
na jaṭāhi na gotreṇa na jāccā hoti brāhmaṇo |	Not because of matted hair, family or birth is one a true brahmin,
yo tu bāhati pāpāni aṇutthūlāni sabbaśo ||	he who wards off wickedness, small or great, in every way,
bāhanā eva pāpānāṃ brahmaṇo ti pravuccati |	through warding off wickedness, he is called a brahmin.
vārī pukkharapatte vā ārāgre-r-iva sāsavo ||	Like water on the lotus leaf, like a mustard seed on a needle,
yo na lippati kāmesu tam ahaṃ brūmi brāhmaṇaṃ |	he who is unsmeared by desires, that one I say is a brahmin.
udayaṃ tapati ādicco ratrim ābhāti candramā ||	The sun is radiant when it rises, the moon shines by night,
sannaddho khattiyo tapati jhāyiṃ tapati brāhmaṇo ||	the accoutred noble is radiant, the meditating brahmin is radiant,
atha sabbe ahorātte buddho tapati tejasā ||	yet during every day and night the Buddha is radiant through his power.
yassa pāram apāram vā pārāpāraṃ na vijjati |	For whom the near shore, the far shore or both do not exist,
vītajjaraṃ visaṃyuttaṃ tam ahaṃ brūmi brāhmaṇaṃ ||	free of fever, detached, that one I say is a brahmin.
yadā dayesu dhammesu pāragū hoti brāhmaṇo |	When a brahmin has, through two things, crossed over,
athassa sabbe saṃyogā atthaṃ gacchanti jānato ||	then, for one who knows, all the fetters are laid to rest.
sa khu so khīṇasaṃyogo khīṇamānapunabbhavo |	He who destroyed the fetter, destroyed conceit and continued existence,
saṃghāvasevī dhammaṭṭho saṃghaṃ na upeti vedagū ||	living in the Community, standing by Dhamma, the knowing one does not approach society.
akakkaśiṃ vinnapaṇiṃ girāṃ saccam udīraye |	Whoever should speak a word of truth that is informed and is not coarse,
tāya nābhiṣape kaṃci tam ahaṃ brūmi brāhmaṇaṃ ||	through which no one would be cursed, that one I say is a brahmin.
asaṃsaṭṭhaṃ gṛhaṭṭhehi anagārehi cūbhayaṃ |	Whoever doesn’t mix with either householders or the houseless,
anokasāriṃ appicchaṃ tam ahaṃ brūmi brāhmaṇaṃ ||	wandering homeless, with few desires, that one I say is a brahmin.
yassa kāyena vācāya manasā nāsti dukkataṃ |	For whom there is no wrong-doing bodily, verbally or mentally,
saṃvṛtaṃ trisu ṭṭhāṇesu tam ahaṃ brūmi brāhmaṇaṃ ||	being restrained in these three things, that one I say is a brahmin.
mā brāhmaṇassa prahare nāssa mucceya brāhmaṇo |	A brahmin should not hit a brahmin, nor should he abandon him,
dhī brāhmaṇassa hantāraṃ ya ssa vā su na muccati ||	woe to the one who strikes a brahmin, and to the one who does not abandon him.
mātaraṃ paṭhamaṃ hantā rājānaṃ do ca khattiye |	Destroying mother first, and then two noble kings,
rāṣṭaṃ sānucaraṃ hantā anigho carati brāhmaṇo ||	destroying a kingdom and its followers, the brahmin lives untroubled.
gambhīrapraṃñaṃ medhāviṃ māggā ’māggassa kovidaṃ |	The deeply wise sagacious one, skilled in what is path and not path,
uttamāttham anuprāttaṃ tam ahaṃ brūmi brāhmaṇaṃ ||	who has reached the ultimate good, that one I say is a brahmin.
jhāyiṃ virajam āsīnaṃ katakiccaṃ anāsavaṃ |	The meditator sitting down, the one who is dustless, who has done his duty, without pollutants,
brāhmaṇavarggaḥ	The Chapter about Brahmins
māggānaṣṭaṃgiko śreṣṭho saccānāṃ caturo padā |	The eightfold is the best of paths, four principles the best of truths,
virāgo śreṣṭho dhammāṇāṃ dupadānāṃ ca cakkhumā ||	dispassion the best of states, the Visionary the best of men.
ākkhāto vo mayā māggo aṃñāye śallasaṃsano |	The path was declared by me, the removal of the dart by knowledge,
tubbhehi kiccam ātappaṃ akkhātāro tathāgatā |	your duty is to have ardour declare the Realised Ones,
paṭipannā pramokkhanti jhāyino mārabaṃdhanā ||	entering this path meditators will be released from the bonds of Māra.
eseva māggo nāstaṃ ’ño daṃśanassa viśuddhiye |	This is the path, there is no other, for insight and for purity,
taṃ māggaṃ paṭipajjahvo mārasse ’sā pramohanī |	you should enter upon this path, this is the confounding of Māra,
etāhi tubbhe paṭipannā dukkhassa antaṃ kariṣyatha ||	having entered upon this path you will make an end to suffering.
vanaṃ chindatha mā rukkhe vanāto jāyate bhayaṃ |	Cut down the forest of defilements not just the trees, from the forest arises a danger,
chettā vanañ ca vanadhañ ca nibbanena gamiśśatha ||	having cut down the forest and thicket, you will go further without forests.
yāvatā vanadho na cchijjati aṇumātto pi narassa ñātisu |	For as long as an atom of desire of a man for his kin is not cut down,
paṭibaddhamano hi tattha so vaccho cchīravako va mātari ||	the mind is in bondage there, like a calf in bondage to mother’s milk.
ucchinna sineham āttano kumudaṃ śāradikaṃ va pāṇinā |	Cut off any affection for one’s self, like an autumn lotus plucked with the hand,
śāntimāggam eva byūhaya nibbāṇaṃ sugatena deśitaṃ ||	develop fully the path to peace and Nibbāna taught by the Fortunate One.
idaṃ vaśśā kariṣyāmi idaṃ hemaṃna gṛhmasu |	Here I will make the rains retreat, here during winter and summer,
iti bālo viciṃteti antarāyaṃ na bujjhati ||	in just such a way a fool thinks, not understanding the danger.
taṃ puttapaśusaṃmattaṃ vyāsattamanasaṃ naraṃ |	That person whose mind is attached and besotted by cattle and children,
suttaṃ ggrāmaṃ mahogho vā maccu-r-ādāya gacchati ||	is snatched away by death just as a sleeping village by a great flood.
na santi puttā ttāṇāya na pitā no pi bhātaro |	Children are not a refuge, nor fathers, not even brothers,
antakenā ’dhibhūtassa nāsti ñātīsu ttāṇatā ||	for one afflicted by the End-Maker there is no refuge in relatives.
krandatām eva ñātīnaṃ vilapatāṃ cevam ekato |	Relatives cry and wail together in this way
janā antarahīyaṃti asakāmā jahaṃti naṃ ||	people still depart, against their desires they give him up.
etaṃ vidiya medhāvī praṃñavā vītamaccharī |	Understanding this the sage, wise, free of selfishness,
taṃ saggagamanaṃ māggaṃ niccam eva viśodhaye |	should constantly purify the path that is leading to heaven.
tassā hi paṇḍito poṣo saṃpaśśaṃ attham āttano |	Therefore a wise man looking for his own welfare
śraddho śīlena saṃpanno praṃñavā susamāhito |	Endowed with faith and virtue, wise, well-composed,
niccaṃ māggaṃ viśodheti sacchayanaṃ sāṃparāyikaṃ ||	one constantly purifies the path, which brings safety in the next world.
śraddho śīlena saṃpanno praṃñavā susamāhito |	Endowed with faith and virtue, wise, composed,
ramate māggam āsevaṃ ajjhattopasame rato ||	delights in practising the path, delights in internal peace.
śraddho śīlena saṃpaṃno praṃñāvāgarato sadā |	Endowed with faith and virtue, always delighting in being wise,
saṃyojanam aṇutthūlaṃ daham aggī va gacchati |	one advances like burning fire against the fetter, small or large,
mānamakkhe va pāpake ||	whether it is wicked conceit or hypocrisy.
aniccā sabbasaṃkhārā yato praṃñāya paśśati |	All conditions are impermanent, when one sees this with wisdom,
atha nivvaṇḍate dukkhā esa māggo viśuddhiye ||	then one grows tired of suffering—this is the path to purity.
sabbadhaṃmā anāttā ti yato praṃñāya paśśati |	All components of mind and body are without self, when one sees this with wisdom,
yogā hi bhūrī saṃbhavati ayogā bhūrisaṃkhayo |	From effort originates wisdom, without effort wisdom is destroyed,
etaṃ jethāpathaṃ ñāttā bhavāya vibhavāya ca |	having understood these two paths of development and decline,
tathā śiccheya medhāvī yathā bhūrī pravaddhati ||	the sage should train so that his wisdom increases.
māggavarggaḥ	The Chapter about the Path
yo nā ’jjhagamī bhavesu sāraṃ vicinaṃ puṣpam iva udumbaresu |	That one who has not found any essence in existences, like one examining a fig tree does not find a flower,
so bhikkhu jahāti orapāraṃ urago jinnam iva ttacāṃ purāṇiṃ ||	that monk abandons the near and far shore, like a snake who has abandoned its old, worn-out skin.
yo uppatitaṃ vineti rāgaṃ visaṭaṃ sappaviṣam va oṣadhīhi |	That one who removes the passion that has arisen, as he would remove pervasive snake venom with medicines,
yo uppatitaṃ vineti doṣaṃ visaṭaṃ sappaviṣaṃ va oṣadhīhi |	That one who removes the hatred that has arisen, as he would remove pervasive snake venom with medicines,
yo uppatitaṃ vineti mohaṃ visaṭaṃ sappaviṣaṃ va oṣadhīhi |	That one who removes the delusion that has arisen, as he would remove pervasive snake venom with medicines,
yo uppatitaṃ vineti krodhaṃ visaṭaṃ sappaviṣaṃ va oṣadhīhi |	That one who removes the anger that has arisen, as he would remove pervasive snake venom with medicines,
yo uppatitaṃ vineti mānaṃ visaṭaṃ sappaviṣaṃ va oṣadhīhi |	That one who removes the conceit that has arisen, as he would remove pervasive snake venom with medicines,
yo rāgam udicchiyā aśeṣaṃ bisapuṣpaṃ va sareruhaṃ vigāhya |	That one who cuts off passion without remainder, like one who has plucked a lotus growing in a lake,
yo doṣam udicchiyā aśeṣaṃ bisapuṣpaṃ va sareruhaṃ vigāhya |	That one who cuts off hatred without remainder, like one who has plucked a lotus growing in a lake,
yo moham udicchiyā aśeṣaṃ bisapuṣpaṃ va sareruhaṃ vigāhya |	That one who cuts off delusion without remainder, like one who has plucked a lotus growing in a lake,
yo krodham udicchiyā aśeṣaṃ bisapuṣpaṃ va sareruhaṃ vigāhya |	That one who cuts off anger without remainder, like one who has plucked a lotus growing in a lake,
yo mānam udicchiyā aśeṣaṃ bisapuṣpaṃ va sareruhaṃ vigāhya |	That one who cuts off conceit without remainder, like one who has plucked a lotus growing in a lake,
yo rāgam udicchiyā aśeṣaṃ kuśa saṃgāni va chetta bandhanāni |	That one who cuts off passion without remainder, having cut the bonds and attachments, like kusa grass,
yo tahnam udicchiyā aśeṣaṃ saritāṃ śīgharayāṃ viśodhayittā |	That one who cuts off craving without remainder, having dried up that quick-flowing stream,
yo nā ’ccasarī na preccasārī sabbaṃ vītasarī imaṃ prapañcaṃ |	He who does not overstep the limit nor lag behind, who is completely free from the limits of this impediment,
yo nā ’ccasarī na preccasārī sabbam idaṃ vitadhaṃ ti moṣadhaṃmaṃ |	He who does not overstep the limit nor lag behind, thinking: “all this is untrue,” a falsity,
yassa vanathā na saṃti keci vinibaṃdhāya bhavāya hetukappā |	For the one with no desire that has arisen, having a cause for bondage to existence,
yassa jarathā na santi keci mūlā akkuśalā samūhatā ’ssa |	For the one with no distress that has arisen, having uprooted all unwholesome roots,
uragavarggaḥ	The Chapter about the Snake
samāptā dharmmapadā amtapadāni gāthāśatāni pañca dve ca gāthe |	Complete are the five hundred and two verses of the Dharma Verses, the Deathless Verses.
yathā dṣṭaṃ tathā likhitam, iti parihāroyam asmadīyaḥ ||	As I saw, so I wrote, giving it our complete attention.
śubham astu sarvvasatvānānaṃ ||	May there be good for all beings!
sabbattha saṃvaro sādhu sādhu sabbattha saṃvaro |	Restraint is good everywhere, restraint is everywhere good,
sabbattha saṃvṛto bhikkhū sabbadukkhā pramuccati ||	a monastic who is restrained everywhere is liberated from all suffering.
kāyena samvaro sādhu sādhu vācāya saṃvaro |	Restraint of body is good, restraint of speech is good,
manasā pi saṃvaro sādhu sādhu sabbattha saṃvaro |	restraint of mind is also good, restraint is everywhere good,
hastasaṃyyato pādasaṃyyato vācāsaṃyyato saṃvṛtendriyo ||	One who controls his hands, controls his feet, controls his speech, controls the mind faculty,
ajjhattarato samāhito eko saṃtuṣito tam āhu bhikkhuṃ |	with inner delight and composure, solitary, content: that one is called a monastic.
śāntakāyo śāntacitto śāntavā susamāhito ||	Calm in body and calm in mind, having calmness and composure,
vāntalokāmiṣo bhikkhū upaśānto ti vuccati |	having thrown off worldly gain the monastic is called one at peace.
yo mukhe saṃyyato bhikkhū mantābhāṣī anuddhato ||	That monastic who restrains the mouth, who speaks well, and who is modest,
atthaṃ dhammañ ca deśeti madhuraṃ tassa bhāṣitaṃ |	who teaches the meaning of the Dhamma, his speech is sweet.
saṃ lābhaṃ nātimaṃñeyā nā ’ṃñesaṃ prihayaṃ care ||	One should not despise one’s own gains, one should not live envious of others,
aṃñesaṃ prihayaṃ bhikkhū samādhin nādhigacchati |	the monastic who is envious of others does not attain concentration.
appalābho pi ce bhikkhū saṃ lābhaṃ nātimaṃñati ||	Even if a monastic gains little he should not despise his gains,
taṃ ve devā praśaṃsanti śuddhājīviṃ atandritaṃ ||	even the very gods praise the one of pure life who is diligent.
siñca bhikkhu imāṃ nāvāṃ sittā te laghu hehiti |	Please bail out this boat, monastic, when bailed out it will go lightly,
hettā rāgañ ca dosaṃ ca tato nibbāṇam ehisi ||	cutting off passion and hatred, from here one will go to Nibbāna.
udāggracitto sumano adhibhūya priyā ’priyaṃ ||	With uplifted mind, happy, having overcome what is dear and not dear,
tato prāmojjabahulo sato bhikkhū parivraje |	then with lots of happiness, the monastic should wander mindfully.
mettāvihārī bhikkhū prasanno buddhaśāsane ||	That monastic who dwells in loving-kindness, with faith in Buddha’s dispensation,
paṭivijjhi padaṃ śāntaṃ saṃkhāropaśamaṃ sukhaṃ |	has penetrated the state of peace, the joy in stilling of all conditions,
dṛṣṭe va dhamme nibbāṇaṃ yogacchemaṃ anuttaraṃ ||	here and now there is Nibbāna, the unsurpassed release from all bonds.
suṃñā ’gāraṃ praviṣṭassa śāntacittassa bhikkhuṇo |	For the one who has entered an empty place, a monastic with a peaceful mind,
amānuṣā ratī hoti sammaṃ dhammaṃ vipaśśato ||	there is superhuman delight from insight into true Dhamma.
yathā yathā sammasati khandhānām udayavyayaṃ |	Just as one with right mindfulness regarding the rise and fall of the components of mind and body
labhate cittassa prāmojjaṃ amatā hetaṃ vijānato ||	gains happiness in mind, this is the deathless state for the one who knows.
nāsti jhānam apraṃñassa praṃñā nāsti ajhāyato |	There is no concentration for one without wisdom, there is no wisdom for one without concentration,
yamhi jhānañ ca praṃñā ca sa ve nibbāṇasantike ||	that one in whom there is concentration and wisdom is indeed close to Nibbāna.
tatthāyam ādī bhavati iha praṃñassa bhikkhuṇo |	This is the very beginning for the wise monastic here:
indriyagottī sāntoṣṭī prātimokkhe ca saṃvaro ||	contentment, guarding the senses, and restraint in the regulations.
mitte bhajetha kallāṇe śuddhājīvī atandrito |	One should resort to spiritual friends, ones of pure life, ones who are diligent,
paṭisandharavaṭṭi ssa ācārakuśalo siyā |	one should be one of friendly disposition, one who will be skilful in conduct,
tato prāmojjabahulo sato bhikkhū parivraje ||	rejoicing frequently because of that, the monastic should wander mindfully.
bhikṣuvarggaḥ	The Chapter about Monastics
yassa accantadośśillaṃ malutā sālam ivo ’tatā |	The one who has an exceeding lack of virtue, like a deadly creeper covering a Sal tree,
karoti so tathāttānaṃ yathā naṃ biṣam icchati ||	makes himself the same as his enemy wishes him to be.
āttanā hi kataṃ pāpaṃ āttajaṃ āttasaṃbhavaṃ |	That wickedness done by oneself, born in oneself, arising in oneself,
anumaṃdhati dummedhaṃ vayiraṃ vā ahmamayaṃ maṇiṃ ||	crushes the one who is stupid, as a diamond crushes a rock-jewel.
āttanā hi kataṃ pāpaṃ āttanā saṃkiliśśati |	By oneself alone is a wicked deed done, by oneself is one defiled,
āttanā akataṃ pāpaṃ āttanā ye viśujjhati |	by oneself is a wicked deed left undone, by oneself is one purified,
śoddhī aśoddhī praccattaṃ nāṃño aṃñaṃ viśodhaye ||	purity and impurity come from oneself, for no one purify another.
na paresaṃ vilomāni na paresaṃ katā ’kataṃ |	Not the wrongs of others, or what others have done or have not done
āttanā ye aveccheyā katāni akatāni ca ||	one should consider, but what has been done and not done by oneself.
na paresaṃ vilomāni na paresaṃ samāsamaṃ |	Not the wrongs of others, or what is just and unjust for others
āttanā ye aveccheyā samāni viṣamāṇi ca ||	one should consider, but what is just and unjust for oneself.
āttānañ ce priyaṃ ñāyyā rakkheyā naṃ surakkhitaṃ |	If one regards oneself as dear one should guard oneself right well,
na etaṃ sulabhaṃ hoti sukhaṃ dukkatakāriṇāṃ ||	for happiness is not easy to gain by those who do wrong.
ttiṇṇam añataraṃ yāmānaṃ paṭijāggreya paṇḍito ||	during one of the three watches of the night the wise one should stay alert.
ekāsanaṃ ekaśeyaṃ ekacariyām atandrito |	Sitting alone, lying down alone, walking alone, diligent,
eko ramayam āttānaṃ vanānte ramitā siyā ||	the solitary one who delights in himself will delight in the edge of a forest.
yo śāsanaṃ arahatāṃ ayirāṇāṃ dhammajīvināṃ |	Whoever reviles the worthy teaching of the Noble Ones who live by Dhamma,
paṭikrośati dummedho dṛṣṭiṃ niśśāya pāpikāṃ |	that stupid one, depending on wicked views,
phalāni kaṇṭakasseva āttaghannāya phallati ||	like the bamboo when it bears fruit, brings about his own destruction.
āttānam eva paṭhamaṃ atthe dhaṃme niveśaye |	First one should establish oneself in the good and the Dhamma,
athāṃñam anuśāseyā evaṃ hohi yathā ahaṃ ||	then one can advise another, saying: ‘You must be as I am’.
āttānam eva paṭhamaṃ paṭirūpe niyojaye |	First one should commit oneself to what is suitable,
athāṃñam anuśāsanto na kiliśśati praṃñavā ||	then when advising another, the wise one should not have any defilement.
āttanā ye tathā kayirā yathāṃñam anuśāsaye |	He should do himself as he would advise another to do,
adānto vata dameyā āttā hi kira duddamo ||	being untrained, he should surely train himself, for it is said the self is difficult to train.
āttā hi bhe varaṃ dānto yacchāyam itarā prajā |	A tamed self is better than that of other people,
āttadāntassa poṣassa sadā saṃyyatacāriṇo ||	for the person who conquers himself, who lives always well-restrained,
neva devā na gandhabbā na māro saha brahmuṇā |	neither gods, nor gandhabbas, nor Māra together with Brahmās,
jitaṃ apajitaṃ kayirā tattharūpassa jantuno ||	can turn conquest into defeat for a person who is like this.
āttā hi āttano nātho ko hi nātho paro siyā |	For the self is the friend of self, for what other friend would there be?
āttanā hi sucinnena nāthaṃ labhati dullabhaṃ ||	When the self is well-practiced, one finds a friend that is hard to find.
āttā hi āttano nātho āttā hi āttano gatī |	Self is the protector of self, self is the refuge of self,
tassā saṃyyamayā ’ttānaṃ aśśaṃ bhadraṃ va vāṇijo ||	therefore one should restrain oneself, as a merchant restrains his noble horse.
āttānam eva damaye aśśasugatiyā sadā |	One should tame oneself always, that will be for a good destiny,
daṃma śaṃma ujjuṃ hohi tato akuṭilo bhava ||	be tamed, be peaceful, be upright, and from that be honest,
tato dānto sukhī hohi anupādāya nivṛto |	then, tamed, be happy, unattached and cooled down.
āttanā codayā ’ttānaṃ parimaśāttānam āttanā |	By oneself one should censure self, by oneself one should be controlled,
so āttagutto satimā sukhaṃ bhikkhū vihāhisi |	he who guards himself, mindful, will live happily, monastic.
āttadātthaṃ parātthena bahunā pi na hāpaye |	One should not neglect one’s own good for another’s, however great;
āttadātthaṃ paraṃ ñāttā sadātthaparamo siyā ||	knowing further what is good for oneself should be the supreme good.
nevāttaheto na parassa heto na saggam icche na dhanaṃ na rāṣṭaṃ |	Not for one’s own sake and not for another’s sake, not desiring heaven, riches, or a kingdom—
necche adhammeṇa samṛddhim āttano so śīlavā praṃñavā dhāṃmiko siyā ||	he should not desire his success through corruption; he should be both virtuous and wise and righteous.
āttavarggaḥ	The Chapter about Self
napuṣpagandho paṭivātam eti na candanaṃ tagaraṃ vāhlikaṃ vā |	The fragrance of flowers goes not against the wind, nor does sandalwood or pinwheel or saffron,
satān tu gandho paṭivātam eti sabbā diśā sappuruṣo pravāti ||	but the fragrance of the good goes against the wind, the true person’s fragrance permeates all directions.
candanaṃ tagaraṃ cāpi uppalaṃ atha vāśśikiṃ |	Sandalwood, pinwheel, then water lily and striped jasmine,
etesāṃ gandhajātānāṃ śīlagandho anuttaro ||	amongst these kinds of fragrance virtue’s fragrance is unsurpassed.
appāmātro ayaṃ gaṃdho yoyaṃ tagaracandane |	Pinwheel and sandalwood fragrance are insignificant,
yo tu śīlavatāṃ gandho vāti devesu uttamo ||	but the fragrance of those who have virtue flutters supreme amongst the gods.
tesāṃ sampannaśīlānāṃ apramādavihāriṇāṃ |	Māra cannot find the path of those endowed with virtue, who live heedfully,
sammadaṃñāvimuttānāṃ māro māggaṃ na viṇḍati ||	and who are freed through right and deep knowledge.
yathā pi ruciraṃ puṣpaṃ vannavantaṃ agandhakaṃ |	Just like a beautiful flower, which has colour, but lacks fragrance,
evaṃ subhāṣitā vācā aphalā hoti akurvvato ||	so are well-spoken words fruitless for the one who acts not on them.
yathā pi ruciraṃ puṣpaṃ vannavantaṃ sagaṃdhakaṃ |	Just like a beautiful flower, which has colour, and has fragrance,
evaṃ subhāṣitā vācā saphalā hoti kurvvato ||	so are well-spoken words fruitful for the one who does act on them.
yathā pi bhramaro puṣpā vannagandham aheḍayaṃ |	Just as a bee, without hurting the flower, its colour or scent,
praḍeti rasam ādāya evaṃ ggrāme munī care ||	gathers its nectar and escapes, so should the seer roam in the village.
puṣpāṇi heva pracinantaṃ vyāsattamanasaṃ naraṃ |	Death takes up and carries away the one whose mind is attached to collecting flowers,
suttaṃ ggrāmaṃ mahogho vā maccu-r-ādāya gacchati ||	like a great flood carries off a sleeping village.
puṣpāṇi heva pracinantaṃ vyāsattamanasaṃ naraṃ |	The End-Maker takes control of the one whose mind is attached to collecting flowers,
asaṃpunnesu kāmesu antako kurute vaśe ||	though he is unfulfilled with sense pleasures.
yathā pi puṣparāśimhā kayirā mālāguṇe bahū |	Just as from a heap of flowers one might make a lot of garlands,
evaṃ jātena māccena kātavvaṃ kuśalaṃ bahuṃ |	so should many good deeds be done by one who is born a mortal.
ko imaṃ paṭhaviṃ vijehiti yamalokaṃ va imaṃ sadevakaṃ |	Who will conquer this earth and the lower realm, together with the gods?
ko dhammapade sudeśite kuśalo puṣpam iva prajehiti |	Who will win the well-taught verses of Dhamma as a good man wins a flower?
śekho paṭhaviṃ vijehiti yamalokaṃ va imaṃ sadevakaṃ |	The trainee will conquer this earth and the lower realm, together with the gods.
so dhammapade sudeśite kuśalo puṣpam iva prajehiti ||	He will win the well-taught verses of Dhamma as a good man wins a flower.
vāśśikī-r-iva puṣpāṇi mañcakāni pramuñcati |	Just as striped jasmine casts off its (…) flowers,
evaṃ rāgañ ca doṣañ ca vipramuñcatha bhikkhavo ||	so, monastics, cast off all passion and hatred.
phenopamaṃ lokam imaṃ vidittā marīcidhammaṃ abhisaṃbudhānāṃ |	Knowing that this world is just like froth, it has the nature of a mirage to those who understand,
chettāna mārassa prapuṣpakāni addaṃśanaṃ maccurājassa gacche ||	cutting off Māra’s flower-tipped arrows, one should go beyond the King of Death’s sight.
yathā saṃkārakūṭamhi ujjhitamhi mahāpathe |	Just as in a forsaken rubbish heap along the highway
padumaṃ ubbhidaṃ assa śucigandhaṃ manoramaṃ ||	a lotus might spring forth, with a pure fragrance, delighting the mind,
evaṃ saṃkārabhūtesu andhabhūte pṛthujjane |	so amongst the forsaken, the Perfect Sambuddha’s disciple
atirocanti praṃñāya saṃmāsabuddhasāvakā ||	outshines the blind and ordinary folk through his wisdom.
puṣpavarggaḥ	The Chapter about Flowers
atthesu jātesusukhā sakhāyā puṃñaṃ sukhaṃjīvitasaṃkhayamhi |	Friends are good whenever need arises, at the break-up of life merit is good,
toṣṭī sukhā yā itarītarena sabbassa pāpassa sukhaṃ prahāṇaṃ ||	being content with everything is good, the abandoning of all wickedness is good.
sukhā mātreatā loke tato petteatā sukhā |	Respecting one’s mother is good in the world, also respecting one’s father is good,
śāmannatā sukhā loke tato brāhmannatā sukhā ||	respecting ascetics is good in the world, also respecting true brahmins is good.
sukhaṃ yāvaj jarā śīlaṃ sukhā śraddhā pratiṣṭhitā |	Virtuous conduct till old age is good, the establishing of faith is good,
sukhā attharasā vācā assiṃ mānakkhayo sukho ||	speech that is beneficial is good, the destruction of conceit is good.
sukho buddhāna uppādo sukhā dhammassa deśanā |	The arising of the Buddhas is good, the teaching of the Dhamma is good,
sukhā saṃghassa sāmaggrī samaggrāṇāṃ tapo sukho ||	the harmony of the Saṅgha is good, devotion to harmony is good.
sukhaṃ daṃśanam ayirāṇāṃ saṃvāso pi satāṃ sukho |	Meeting with the noble is pleasant, living with good people is pleasant,
addaṃśanena bālānāṃ niccam eva sukhī siyā ||	through not meeting foolish people one will constantly be happy.
bālāsaṅgatacārī hi drīgham addhāna śocati |	For he who consorts with fools grieves for a long time,
dukkho bālehi saṃvāso amittehi-r-iva sabbadā |	dwelling with fools is always suffering as it is with enemies,
dhīrā tu sukhasaṃvāsā ñātīnaṃ vā samāgamo ||	the wise ones dwell happily as with an assembly of kin.
tassā hi dhīraṃ ca bahuśśutañ ca dhoreyaśīlavratamantam ayiraṃ |	Therefore the firm and the learned, the virtuous, dutiful and noble—
taṃ tārisaṃ sappuruṣaṃ sumedhaṃ sevetha nakkhattapathe va candramā ||	follow such a true and intelligent person as the moon follows the course of the stars.
priyāto jāyate dukkhaṃ priyā śokā priyā bhayaṃ |	From love there arises grief, with love grief, with love fear,
priyāto vipramuttassa nāsti śokā kato bhayaṃ ||	for one who is free from love there is no grief, how is there fear?
mā priyehi samāgaṃma apriyehi kadācanaṃ |	Do not associate at any time with those who are loved or with those unloved,
priyassa addaṃśanaṃ dukkhaṃ apriyassa ca daṃśanaṃ ||	there is suffering not meeting the loved one, and suffering from meeting the unloved one.
tassā priyaṃ na kayirātha priyāvādo hi pāpako |	Therefore do not hold anything as loved, for speaking of the loved is loathsome.
ggraṃthā tesaṃ na vijjanti yesaṃ nāsti priyāpriyaṃ ||	There are no knots for those who hold nothing as loved or as unloved.
chudhā parama rogāṇāṃ saṃkhāraparamaṃ dukhaṃ |	Hunger is the supreme sickness, conditions are the supreme suffering,
etaṃ ñāttā yathābhūtaṃ nibbāṇaparamaṃ sukhaṃ ||	knowing this as it really is, know Nibbāna is the supreme good.
āroggaparamā lābhā sāṃtoṣṭīparamaṃ dhanaṃ |	Health is the supreme gain, content the supreme wealth,
viśśāsaparamā ñātī nibbāṇaparamaṃ sukhaṃ ||	confidence the supreme kin, Nibbāna the supreme good.
māttāsukhapariccāgā paśśe ce vipulāṃ sukhaṃ |	If, by renouncing a small good, he might see a good that is large,
caje māttāsukhaṃ dhīro saṃpaśśaṃ vipulāṃ sukham ||	the wise one should renounce that small good, seeing the good that is extensive.
manujassa sadā satīmato māttaṃ jāniya laddhibhojane |	For a human who is always mindful, knowing the measure in food received,
tanukā ’ssa bhavanti vedanā śanikaṃ jīrati āyu pālayaṃ ||	his painful feelings become slight, he ages slowly, guarding his lifespan.
dullabho puruṣājaṃño na so sabbattha jāyati |	A person of good breed is rare, that one is not born everywhere,
yattha so jāyate vīro taṃ kulaṃ sukham edhati ||	wherever that hero is born, that family gains happiness.
sabbattha ve sappuruṣā bhavanti na kāmakāmā lapayanti santo |	There are surely true people everywhere, the good do not talk of desiring sense-pleasures;
sukhena phuṭṭhā uttavā dukhena noccāvacaṃ sappuruṣā karonti ||	when touched by pleasure or by suffering, true people are not elated or depressed.
jayaṃ veraṃ prasavati dukkhaṃ śeti parājito |	The victor generates hatred, the defeated one finds suffering,
upaśānto sukhaṃ śeti hettā jayaparājayaṃ ||	the one at peace lives happily, having abandoned victory and defeat.
sukhā najjo sūpatitthā sukho dhammajito jano |	Pleasant are rivers with good fords, pleasant is the person conquered by Dhamma,
sukho śraddhapaṭīlābho pāpassa akaraṇaṃ sukhaṃ ||	the acquisition of faith is good, doing nothing wicked is good.
sukhaṃ draṣṭuṃ śīlavanto sukhaṃ draṣṭuṃ bahuśśutā |	It is pleasant to meet the virtuous, it is pleasant to meet the learned,
arahanto pi sukhaṃ draṣṭuṃ vipramuttā niropadhī ||	it is pleasant to meet the Worthy Ones, who are free from attachments.
atthavarggaḥ	The Chapter about Need
phandanaṃ capalaṃ cittaṃ durakkhaṃ dunnivārayaṃ |	An agitated, unsteady mind, difficult to guard, difficult to ward,
ujjuṃ karoti medhāvī uṣukāro va tejanā ||	the sagacious one makes straight, as a fletcher does his arrows.
vārijo va thale khitto okamokātu ubbhato |	Like a fish thrown up on dry land, pulled out from its watery home,
pariphandatimaṃ cittaṃ māradheyaṃ prahātaye ||	the mind is agitated, one ought to throw off the sway of Māra.
dūraṃgamaṃ ekacaraṃ aśarīraṃ guhāśayaṃ |	Those who will restrain the mind that roams far,
ye cittaṃ saṃyyamehinti mokkhaṃte mārabaṃdhanā ||	is lonesome, without a body, hidden, gain release from the bonds of Māra.
dunniggrahassa laghuno yatthakāmanipātino |	For the mind that is difficult to subdue, flighty, flitting wherever it will,
cittassa damatho sādhu cittaṃ dāntaṃ sukhāvahaṃ ||	restraint is good, a restrained mind brings happiness.
sududdaśaṃ sunipuṇaṃ yatthakāmanipātinaṃ |	Hard to see, very subtle, flitting wherever it will,
cittaṃ rakkheya medhāvī tadahi guttaṃ sukhāvahaṃ ||	the sage should guard the mind, for guarded it brings happiness.
anaprāśrayamāṇassa ananvāhatacetaso |	For the one with mind that is not dependent, for the one with mind unperplexed,
hettā kallāṇapāpāni nāsti jāgarato bhayaṃ ||	having abandoned the wholesome and demerit, for the watchful, there is no fear.
dhammaprītirasaṃ pāttā viprasannena cetasā |	The one who drinks the tasty Dhamma drink, with a clear mind,
ayirapravedite dhamme sadā ramati paṇḍito ||	the wise one will always delight in the Dhamma that is made known by the Noble.
acirā vata ayaṃ kāyo paṭhaviṃ abhiśehiti |	Before long has passed by, alas, this body will lie on the ground,
chūḍo apetaviṃnyāṇo nirātthaṃ vā kaṭiṃgaraṃ ||	rejected, without consciousness, just like a useless piece of wood.
kuṃbhopamaṃ kāyam imaṃ vidittā nagaropamaṃ cittam adhiṣṭhihittā |	Knowing this body is frail like a jar, govern the mind like a fortress,
yodheya māraṃ praṃñāyudhena jitaṃ ca rakkhe aniveśano siyā ||	one should fight Māra with the weapon of wisdom, guard your success, and do not be attached.
yathā agāraṃ ducchannaṃ vaṭṭhī samitivijjhati |	Just as the rain penetrates a house with thatching that is poor,
evaṃ abhāvitaṃ cittaṃ rāgo samitivijjhati ||	so passion penetrates a mind that is undeveloped.
yathā agāraṃ succhannaṃ vaṭṭhī na samitivijjhati |	Just as rain does not penetrate a house with thatching that is good,
evaṃ subhāvitaṃ cittaṃ rāgo na samitivijjhati ||	so passion cannot penetrate a mind that is well-developed.
evaṃ abhāvitaṃ cittaṃ doṣo samitivijjhati ||	so hatred penetrates a mind that is undeveloped.
evaṃ subhāvitaṃ cittaṃ doṣo na samitivijjhati ||	so hatred cannot penetrate a mind that is well-developed.
evaṃ abhāvitaṃ cittaṃ moho samitivijjhati ||	so delusion penetrates a mind that is undeveloped.
evaṃ subhāvitaṃ cittaṃ moho na samitivijjhati ||	so delusion cannot penetrate a mind that is well-developed.
sabbapāpassa akaraṇaṃ kuśalassa apasaṃpadā |	The non-doing of anything wicked, undertaking of what is good,
sacittapariyodamanaṃ etaṃ buddhāna śāsanaṃ ||	the training of one’s mind—this is the teaching of the Buddhas.
cittavarggaḥ	The Chapter about the Mind
21. sahasra	21. The Chapter about Thousands
sahasram api ce vācā anatthapadasāhitā |	Though there are a thousand sayings consisting of useless words,
ekaṃ atthapadaṃ śreyo yaṃ śottā upaśāṃmati ||	better is one useful word, hearing which one is brought to peace.
yo ca gāthāśataṃ bhāṣe anatthapadasāhitaṃ |	One may speak a thousand verses consisting of useless words,
ekaṃ dhamapadaṃ śreyo yaṃ śottā upaśāṃmati ||	better is one verse of Dhamma, hearing which one is brought to peace.
yo sahasraṃ sahasrāṇāṃ saṃggrāme mānuṣe jine |	One may conquer a thousand men a thousand times in a battle,
ekaṃ ca paṃñam āttānaṃ sa ve saṃggrāmamuttamo ||	but having conquered another, one’s self, one would surely be supreme in battle.
māse māse sahasreṇa yo yajeya śataṃ samā |	One might give alms impartially with a thousand coins of money month by month for a hundred years;
ekañ ca bhāvitāttānaṃ muhuttam api pūjaye |	and one might worship someone with developed self for a second—
sā eva pūjanā śreyo yac cha vaśśaśataṃ hutaṃ ||	that worship is surely better than the hundred-year sacrifice.
yo ca vaśśaśataṃ jantū aggiṃ paricare vane |	One person might care for the fire in the woods for a hundred years;
yaṃ kiñci yaṣṭaṃ va hutaṃ va loke saṃvatsaraṃ yajate puṃñapekhī |	Whatever the alms or the sacrifice in the world the one seeking merit may give for a year,
sabbaṃ pi taṃ na catubbhāgam eti abhivādanā ujjugatesu śreyo ||	all that comes not to a quarter of the merit—better is the worship of the upright.
na taṃ buddhe prasādassa kalām agghati ṣoḍaśiṃ ||	but that is not worth a sixteenth part of having confidence in the Buddha.
na taṃ dhamme prasādassa kalām agghati ṣoḍaśiṃ ||	but that is not worth a sixteenth part of having confidence in the Dhamma.
na taṃ saṃghe prasādassa kalām agghati ṣoḍaśiṃ ||	but that is not worth a sixteenth part of having confidence in the Saṅgha.
na taṃ sākhātadhaṃmāṇāṃ kalām agghati ṣoḍaśiṃ ||	but that is not worth a sixteenth part of those who have mastered Dhamma.
māse māse kuśāggreṇa bālo bhuñjeya bhojanaṃ |	From month to month the fool may eat food with the tip of kusa grass,
yo ca vaśśaśataṃ jīve duśśīlo asamāhito |	One might live for a hundred years, unvirtuous and uncomposed,
ekāhaṃ jīvitaṃ śreyo śīlavantassa jhāyato ||	but a life of one day is better, for one with virtue and meditation.
yo ca vaśśaśataṃ jīve dupraṃño asamāhito |	One might live for a hundred years, lacking in wisdom and uncomposed,
ekāhaṃ jīvitaṃ śreyo praṃñavantassa jhāyato ||	but a life of one day is better, for one endowed with wisdom and meditation.
yo ca vaśśaśataṃ jīve kusīdo hīnavīriyo |	One might live for a hundred years, indolent, with less energy,
ekāhaṃ jīvitaṃ śreyo vīryyam ārabhato dṛḍaṃ ||	but a life of one day is better, for one with energy set up and firm.
yo ca vaśśaśataṃ jīve apaśśaṃ udayavyayaṃ |	One might live for a hundred years, without seeing rise and fall,
ekāhaṃ jīvitaṃ śreyo paśśato udayavyayaṃ ||	but a life of one day is better, for the one seeing rise and fall.
yo ca vaśśaśataṃ jīve apaśśaṃ dhammam uttamaṃ |	One might live for a hundred years, without seeing the supreme state,
ekā ’haṃ jīvitaṃ śreyo paśśato dhammam uttamaṃ ||	but a life of one day is better, for one seeing the supreme state.
yo ca vaśśasataṃ jīve apaśśaṃ amataṃ padaṃ |	One might live for a hundred years, without seeing the deathless state,
ekā ’haṃ jīvitaṃ śreyo paśśato amataṃ padaṃ ||	but a life of one day is better, for one seeing the deathless state.
yo ca vaśśasataṃ jīve saddhaṃme apratiṣṭhito |	One might live for a hundred years, unestablished in the True Dhamma,
ekā ’haṃ jīvitaṃ śreyo sadhaṃmam iha vijānato ||	but a life of one day is better, for one who knows the True Dhamma.
yo ca vaśśasataṃ jīve aprāpya āsavakkhayaṃ |	One might live for a hundred years, having not attained the destruction of the pollutants,
ekā ’haṃ jīvitaṃ śreyo prāpyato āsavakkhayaṃ ||	but a life of one day is better, for one who has attained the destruction of the pollutants.
sahasravarggaḥ	The Chapter about the Thousands
siddhaṃ namaḥ sarvvabuddhadharmmāryyasaṅghebhyaḥ	Hail and Homage to all Buddhas, Dharmas and the Noble Saṅghas.
manopūrvvaṃgamā dhammā manośreṣṭhā manojavā |	Mind precedes thoughts, mind is their chief, they are impelled by mind,
manasā ca praduṣṭena bhāṣate vā karoti vā |	if with a base mind one speaks or acts,
tato naṃ dukham anneti cakram vā vahato padaṃ ||	through that, suffering follows him like a wheel follows the ox’s foot.
manasā ca prasannena bhāṣate vā karoti vā |	if with pure mind one speaks or acts,
tato naṃ sukham anneti cchāyā vā anapāyinī ||	through that, happiness follows him like a shadow which does not depart.
iha śocati precca śocati pāpakammo ubhayattha śocati |	Here he laments, after death he laments, the wicked one laments in both places,
so śocati so vihaṃnyati dṛṣṭā kammakileśam āttano ||	he laments, he suffers vexation, seeing the defilement of his own deeds.
iha nandati precca nandati katapuṃño ubhayattha nandati |	Here he is happy, after death he is happy, the meritorious one is happy in both places,
so nandati dati dṛṣṭā kammaviśuddhim āttano ||	he is happy… seeing the purity of his own deeds.
ākrośi maṃ avadhi maṃ ajini maṃ ahāsi me |	“He abused me, he struck at me, he overcame me, he robbed me,”
ye tāni upanahyanti veraṃ tesaṃ na śāmyati ||	those who bear these ill-will their hatred is never appeased.
ye tāni nopanahyanti veraṃ tesaṃ upaśāmyati ||	those who do not bear these ill-will their hatred is appeased.
śubhā ’nupaśśiṃ viharantaṃ indriyesu asaṃvṛtaṃ |	Living contemplating what is pleasant, uncontrolled in sense faculties,
bhojanamhi amāttaṃñū kuśīdaṃ hīnavīriyaṃ ||	not knowing the limit in food, indolent, low in energy—
taṃ ve prasahate māro vāto rukkham va dubbalaṃ |	Māra surely overthrows that one, like wind overthrows a weak tree.
aśubhānupaśśiṃ viharantaṃ indriyeṣu susaṃvṛtaṃ ||	Living contemplating the unpleasant, well-controlled in sense faculties,
bhojanamhi ca māttraṃñū saddhaṃ āraddhavīriyaṃ |	and knowing the limit in food, faithful, with energy aroused—
taṃ ve na prasahate māro vāto śelaṃ va parvvataṃ ||	Māra does not overthrow that one, just as wind does not overthrow a mountain made of rock.
sace labheyā nipakaṃ sapraṃñaṃ sāddhiṃcaraṃ sādhuvihāradhīraṃ |	If you should find a prudent, wise companion, one who lives well, a wise one,
adhibhūya sabbāṇi pariśravāṇi careyā tenāttamano satīmā ||	overcoming all your troubles you should live with that one, glad and mindful.
no ce labheyā nipakaṃ sapraṃñaṃ sāddhiṃcaraṃ sādhuvihāradhīraṃ |	If you do not find a prudent, wise companion, one who lives well, a wise one,
rājā va rāṣṭaṃ vijitaṃ prahāya eko ccare mātaṃgāranne va nāgo ||	like a king who abandons his conquered kingdom, one should live alone like a solitary elephant in the forest.
ekassa caritaṃ śreyo nāsti bāle bitīyatā |	It is better to live alone, there can be no companionship with a fool,
eko ccare na ca pāpāni kayirā appussuko mātaṃgāranne va nāgo ||	one should live alone and not do anything bad, unconcerned like a solitary elephant in the forest.
chandadoṣabhayā mohā yo dhammaṃ ativattati |	He who, through desire, hatred, fear or delusion, transgresses Dhamma,
nīhīrate tassa yaśo kālapakkhe va candramā ||	his fame diminishes, like the moon in the dark fortnight.
chandadoṣabhayā mohā yo dhammaṃ nātivattati |	He who, through desire, hatred, fear or delusion, does not transgress Dhamma,
āpūrate tassa yaśo śuklapakkhe va candramā ||	his fame increases, like the moon in the bright fortnight.
jamavarggaḥ	The Chapter about the Pairs
ye keci śokā paridevitaṃ vā dukkhaṃ va lokamhi anekarūpaṃ |	Whatever griefs or lamentations there are, and the many kinds of suffering in the world,
priyaṃ paṭicca prabhavanti ete priye asante na bhavanti ete ||	these all arise because of love, without loves, these do not originate.
tassā hi te sukhino vītaśokā yesaṃ priyaṃ nāsti kahiṃci loke |	Therefore they are happy and free from grief, who are without love for anything in the world,
tassā aśokaṃ virajaṃ prātthayānā priyaṃ na kayirātha kahiṃci loke ||	therefore those wanting what is griefless, dust-free, should not have love for anything in the world.
gataddhuno viśokassa vipramuttassa sabbahiṃ |	For the one who has reached his goal, who grieves not, being released on all sides,
sabbaggrantaprahīṇassa paridāhā na vijjati ||	who has abandoned all the knots, no consuming fever is found.
yesāṃ sannicayo nāsti ye pariñātabhojanā |	For those who have no stores, those who comprehend food aright,
ākāśe va śakuntānāṃ padaṃ tesāṃ durannayaṃ ||	like the birds in the sky, their footprint is hard to find.
śānto tassa mano hoti śāntā vācā ca kaṃmu ca |	His mind is calm, his speech and his actions are also calm,
saṃmadaṃñāvimuttassa upaśāntassa tāyino ||	liberated by right knowledge, such a one is truly peaceful.
yassendriyāṇi samathaṃ gatāni aśśā yathā sārathinā sudāntā |	For the one whose senses are balanced, like horses well-trained by their charioteer,
prahīṇamānassa anāsavassa devā pi tassa prihayanti tāyino ||	who has abandoned conceit, who is without pollutants—even the gods envy such a one.
dāntaṃ nayanti samitiṃ dāntaṃ rājābhirūhati |	They lead one trained into a crowd, a king mounts one who has been trained,
dānto śreṣṭho manuṣyesu yo ’tivāde titikkhati ||	amongst humans one trained is best, the one who can endure reproof.
varam assatarā dāntā ājāneyā ca sendhavā |	Noble are the well-trained horses, the well-bred horses from Sindh,
kuñjarā va mahānāgā āttā dānto tato varaṃ ||	and the great tusker elephants, and even more noble than that is the one who has trained himself.
na hi tehi jānajātehi tāṃ bhūmim abhisaṃbhave |	Not by these vehicles can one reach that place,
yathā ’ttanā sudāntena dānto dāntena gacchati ||	as one through training himself well, being trained by the training, goes.
śelo yathā ekaghano vātena na samīrati |	Just as solid rock is not shaken by the wind,
evaṃ nindāpraśaṃsāsu na samīranti paṇḍitā ||	so the wise are not shaken by blame or praise.
anikkaṣāyo kāṣāyaṃ yo vastaṃ paridhehiti |	The one who, while still impure, would wear the renunciant’s robe,
apeto damasaccena na so kāṣāyam arihati ||	unendowed with restraint and truth, is not worthy of the renunciant’s robe.
yo tu vāntakaṣāyassa śīlehi susamāhito |	The one who, steady in virtue, throws out any impurity,
upeto damasaccena sa ve kāṣāyam arihati ||	endowed with restraint and truth, is indeed worthy of the renunciant’s robe.
śokavarggaḥ	The Chapter about Grief
manujassa pramattacāriṇo tahnāvaddhatimālutā iva |	For a human who lives life heedlessly craving increases like a clinging creeper,
sā prāplavate hurāhuraṃ phalameṣī va vanamhi vānnaro ||	he rushes from one place to another like a monkey seeking fruit in the forest.
yaṃ cesā sahate jaṃmī tahnā loke duraccayā |	That one who is overcome by these low cravings in the world, which are difficult to get past,
śokā tassa pravaddhaṃti ovaṭṭhā beruṇā iva ||	for him griefs increase like grass that has been rained upon.
yo cetāṃ sahate jaṃmiṃ tahnāṃ loke duraccayāṃ |	Whoever overcomes this low craving in the world, which is difficult to get past,
śokā tassa vivaṭṭanti udabindū va pukkhare ||	griefs roll from him like a drop of water on a lotus.
taṃ vo vademi bhadraṃ vo yāvaṃt-ittha samāgatā |	This I say to you: “Good luck to as many as have assembled here”,
tahnāṃ samūlāṃ khaṇatha uṣīrātthī va beruṇiṃ |	dig up the root of craving, like one seeking the root digs up grass,
tahnāya khatamūlāya nāsti śokā kato bhayaṃ ||	for one who has cut off the root of craving there are no griefs, how is there fear?
tahnabitiyo puruṣo drīgham addhāna saṃsari |	A man with craving as companion has a long time in births-and-deaths,
etthabhāvaṃñathābhāvaṃ tattha tattha punappuno ||	in this existence or another existence, here and there, again and again.
etam ādīnavaṃ nyāttā tahnā dukkhassa saṃbhavaṃ |	Having understood the danger, that craving is the origination of suffering,
vītatahno anādāno sato bhikkhū parivraje ||	free from craving, without attachment, the monastic should wander mindfully.
na taṃ dṛḍhaṃ bandhanam āhu dhīrā yad āyasaṃ dārujaṃ babbajaṃ vā |	That bondage is not so strong say the wise, that is made of iron or wood or reeds,
sārattarattā maṇikuṇḍalesu putresu dāresu ca yā apekhā ||	impassioned and excited they seek out jewels and earrings and children and wives—
etaṃ dṛḍhaṃ bandhanam āhu dhīrā ohārimaṃ sukhumaṃ dupramuñcaṃ |	that bondage is strong say the wise, dragging down, subtle, hard to get free from,
etappi chettāna vrajanti santo anapekhino sabbadukhaṃ prahāya ||	having cut this down the good go peacefully seeking nothing, abandoning all suffering.
na kāhāpaṇavāsena ttrettī kāmesu vijjati |	Not through a rain of coins is satisfaction found for sense desires,
appāssādā dukhā kāmā iti viṃñāya paṇḍito ||	the wise one knowing: “Sense pleasures have little joy, much suffering,”
api divvesu kāmesu ratiṃ so nādhigacchati ||	does not find delight even in heavenly pleasures.
tahnakkhayarato hoti saṃmasaṃbuddhasāvako ||	The disciple of the Perfect Sambuddha delights in craving’s destruction.
vītatahno anādāno niruttīpadakovido |	Without craving, without attachment, skilled in words and their explanation,
akkharāṇāṃ sannipātena ñāyyā pūrvvāparāṇi so |	knowing how syllables are arranged, which come before and which after,
sa ve antimaśārīro mahāpraṃño ti vuccati ||	the one in his final body is said to be one of great wisdom.
saritāni sinehitāni ca somanassāni bhavanti jantuno |	There are flowing streams of affection and mental happinesses for a person,
ye sātasitā sukheṣiṇo te ve jātijaropagā ||	pleasure-dependent they seek happiness, those people undergo birth and old age.
tahnāya purekkhaṭā prajā parisappanti śaśo va bādhito |	People surrounded by craving crawl round like a hare in a trap,
te saṃjotanasaṅgasattā gabbham upenti punappuno ciraṃ pi ||	they are attached and clinging to fetters, they come back again and again to the womb for a long time.
muñca pure muñca pacchato majjhe muñca bhavassa pāragū |	Be free of the past, be free of the future, be free of the present, after crossing over all existence,
sabbattha vimuttamānaso na puno jātijarām upehisi ||	with mind liberated in every way, you will not return to birth and old age.
yo nivvanadho vanā tu mutto vanamutto vanam eva dhāvati |	The one who is free from desires, who is free in the forest, though free from the forest, runs back to the forest,
taṃ puggalam etha paśśatha mutto bandhanam eva dhāvati ||	come here and look at that person, though free, he runs back to bondage.
ttriṇadoṣāṇi khettrāṇi rāgadoṣā ayaṃ prajā |	Fields are ruined by grassy weeds, these people are ruined by passion,
tassā hi vītarāgesu dinnaṃ hoti mahapphalaṃ ||	therefore there is great fruit for that given to those without passion.
ttriṇadoṣāṇi khettrāṇi doṣadoṣā ayaṃ prajā |	Fields are ruined by grassy weeds, these people are ruined by hatred,
tassā hi vītadoṣesu dinnaṃ hoti mahapphalaṃ ||	therefore there is great fruit for that given to those without hatred.
ttriṇadoṣāṇi khettrāṇi mohadoṣā ayaṃ prajā |	Fields are ruined by grassy weeds, these people are ruined by delusion,
tassā hi vītamohesu dinnaṃ hoti mahapphalaṃ ||	therefore there is great fruit for that given to those without delusion.
ramaṇīyaṃ vatā ’raṇṇaṃ yamhiṃ na ramate jano |	The delightful wilderness wherein the people do not delight,
vītarāgāttha raṃsanti nāṃñe kāmagaveṣiṇo ||	those without passion delight therein, but not those who seek sense pleasures.
yathā pi mūle anupadrute dṛḍhe chinno pi rukkho punar-īva jāyati |	Just as when the root remains firm and undamaged though the tree was cut down, it springs up again,
em eva tahnānuśaye anūhate nivvattate dukkham idaṃ punappuno ||	so when the tendency to craving is not rooted out this suffering appears again and again.
tahnavarggaḥ	The Chapter about Craving
2. apramāda	2. The Chapter about Heedfulness
apramādo amatapadaṃ pramādo maccuno padaṃ |	Heedfulness is the deathless state, heedlessness the state of the dead,
apramattā na mrīyanti ye pramattā yathā matā ||	the heedful do not die, but those who are heedless are as if dead.
etaṃ viśeṣataṃ nyāttā apramādamhi paṇḍitā |	The wise, understanding this difference in regard to heedfulness,
apramāde pramodanti ayirāṇāṃ gocare ratā ||	rejoice in heedfulness, delight in the domain of the Noble Ones.
te jhāyino sātatikā niccaṃ dṛḍhaparākramā |	Those who meditate all the time, constant and firm in their effort,
phusanti dhīrā nibbāṇaṃ yogacchemaṃ anuttaraṃ ||	those wise ones reach Nibbāna, the unsurpassed release from all bonds.
pramādam anuyuñjanti bālā dummedhino janā |	The foolish and stupid people cultivate heedlessness,
apramādan tu medhāvī dhanaṃ śreṣṭhaṃ va rakkhati ||	but the sagacious one guards heedfulness just as his greatest wealth.
apramatto pramattesu suttesu bahujāgaro |	Heedful amongst the heedless ones, wakeful amongst the ones who sleep,
abalāśśam va śīghrāśśo hettā yāti sumedhaso ||	like a swift horse who abandons a weak horse, the true sage moves on.
pramādam apramādena yadā nudati paṇḍito |	When the wise one eliminates heedlessness with his heedfulness,
praṃñāprāsādam āruyha aśoko śokiniṃ prajāṃ |	and mounts the palace of wisdom, griefless, he looks on grieving people;
parvvataṭṭho va bhoma ’ṭṭhe dhīro bāle avecchati ||	the wise one, like one standing on a mountain, looks down on the fools who are standing on the plains.
pūrvve cāpi pramajjittā yo pacchā na pramajjati |	Whoever before was heedless, but later is not heedless,
so imaṃ lokaṃ prabhāseti abhramutto va candramā ||	that one shines brightly in this world like the moon released from a cloud.
so imāṃ visattikāṃ loke sato samativattati ||	he, being mindful, can overcome clinging to the world.
apramādagaru bhikkhū pramāde bhayadaṃśino |	A monastic who values heedfulness, seeing danger in heedlessness,
abhavvo parihāṇāya nibbāṇasseva santike ||	is unable to fall away: he is well-nigh to Nibbāna.
saṃyojanam aṇutthūlaṃ dahaṃ aggīva gacchati |	advances like burning fire against the fetter, small or large.
apramādaratā hotha saṃ cittam anurakkhatha ||	You should delight in heedfulness, you should always protect your mind,
duggā uddharathāttānaṃ pake sanno va kuñjaro |	you should raise yourself from this pit like the tusker sunk in the mud.
apramāde pramudino nipakā śīlasaṃvṛtā ||	Rejoicing in heedfulness, prudent, restrained in virtue,
te ve kālena prācchanti yattha prātto na śocati |	in good time they attain that where, once attained, there is no grieving.
mā pramāde pramodetha na kāmaratisandhave ||	Do not rejoice in heedlessness, unacquainted with delight in sensual pleasure,
evaṃ viharan ātāpī śāntacitto ’nuddhato |	living in this way, ardent, with mind at peace, not proud,
cetośamatham anuyutto dukkhassantakaro siyā ||	devoted to mental calm, he will make an end to suffering.
uṭṭheyā na pramajjeyā dhammaṃ sucaritaṃ care |	One should strive, not be heedless, one should live by Dhamma, with good conduct,
dhammacārī sukhaṃ śeti aśśiṃ loke paramhi ca ||	living by Dhamma one lives at ease in this world and the next.
uṭṭhāṇavato satīmato śucikammassa niśāmmakāriṇo |	For he who is active, mindful, pure in deeds, considerate,
saṃyyatassa ca dhammajīvino apramattassa yaśo ’ssa vaddhati ||	self-controlled, living by Dhamma, heedful, his fame increases.
uṭṭhāṇenā ’pramādena saṃyyamena damena ca |	Through activity, heedfulness, through self-control and through restraint,
dīpaṃ kayirātha medhāvī yam ogho nādhipūrati ||	the sage should make an island that no flood waters can overwhelm.
uṭṭhāṇakālamhi anuṭṭhihāno yuvā balī ālasiko upoko |	The one who has not energy at a time for energy, youthful, strong, lazy in his home,
saṃsannasaṃkappamano kusīdo praṃñāya māggaṃ alaso na yeti ||	whose mind lacks right intention and is indolent—the lazy one does not go along wisdom’s path.
hīnaṃ dhammaṃ na seveyā pramādena na samvase |	One should not follow lowly things, one should not abide heedlessly,
micchadṛṣṭiṃ na seveyā na siyā lokavaddhano ||	one should not follow a wrong view, one should not foster worldliness.
na tāvatā dhammadharo yāvatā bahu bhāṣati |	One is not a Dhamma-bearer merely through speaking much,
yo tu appam pi sottāna dhammaṃ kāyena phassaye |	but the one who, having heard a little, would see Dhamma for himself,
sa ve dhammadharo hoti yo dhamme na pramajjati ||	is one who bears Dhamma, the one who is not heedless regarding Dhamma.
dhammaṃ vicinātha apramattā mā vo kāmaguṇā bhrameṃsu cittaṃ |	Consider the Dhamma heedfully, do not let your mind swirl around in strands of desire,
mā lohaguḍe gilaṃ pramatto kraṇḍe dukkham idan ti dayhamāno ||	do not, heedless, swallow a hot iron ball, and, while burning, cry: ‘This is suffering.’
apramādavarggaḥ	The Chapter about Heedfulness
bahū veśaraṇaṃ yānti parvvate ca vanāni ca |	Many people shaken by fear go for refuge
vastūni rukkhacittāṇi manuṣyā bhayatajjitā ||	to mountains and woods, to places with beautiful trees.
na etaṃ śaraṇaṃ khemmaṃ na etaṃ śaraṇam uttamaṃ |	That is not a secure refuge, that is not the refuge supreme,
etaṃ śaraṇam āgaṃma sabbadukkhā pramuccati ||	nor is it the refuge to come to that liberates from all suffering.
yo tu buddhañ ca dhammañ ca saghaṃ ca śaraṇaṃ gato |	Whoever has gone for refuge to the Buddha, the Dhamma and the Saṅgha,
cattāri ca ariyasaccāni yathābhūtāni paśśati ||	and who sees as it really is the four noble truths.
etaṃ ve śaraṇaṃ khemmaṃ etaṃ śaraṇam uttamaṃ |	That is a secure refuge, that is the refuge supreme,
etaṃ śaraṇam āgamma sabbadukkhā pramuccati ||	that is the refuge to come to that liberates from all suffering.
gavāṃ ce taramāṇānāṃ jihmaṃ gacchati puṅgavo |	If, when cows are crossing a road, their leader goes crookedly,
sabbā tā jihmaṃ gacchaṃti nette jihmagate sati ||	they all will go crookedly, as their guide crookedly does go.
evām eva manuṣyesu yo hoti śreṣṭhasaṃmato |	So it is with humans, he who is agreed upon as chief,
sa ce adhaṃmaṃ carati prāg eva itarā prajā ||	if he lives unrighteously, so will other people.
gavāṃ ce taramāṇānāṃ ujjuṃ gacchati puṅgavo |	If, when cows are crossing a road, their leader goes straight,
sabbā tā ujjuṃ gacchaṃti nette ujjugate sati ||	they all will go straight, as their guide straight does go;
evām eva manuṣyesu yo hoti śreṣṭhasaṃmato |	so it is with humans, he who is agreed upon as chief,
sa ce va dhaṃmaṃ carati prāg eva itarā prajā ||	if he lives righteously, so will other people.
dhaṃmaṃ care sucaritaṃ na naṃ duccaritaṃ care |	One should live by Dhamma, with good conduct, not with bad conduct,
brahmacārī sukhaṃ śeti assiṃ loke paramhi ca ||	living the holy life one lives at ease in this world and the next.
dhaṃmārāmo dhaṃmarato dhaṃmaṃ anuvicintayaṃ |	The one who finds pleasure in the Dhamma, delights in Dhamma, reflects on Dhamma,
dhammaṃ anussaraṃ bhikkhū dhammā na parihāyati ||	the monastic who remembers Dhamma, does not abandon the Dhamma.
dhammo have rakkhati dhammacārī dhammo sucinno sukhāya dahāti |	The Dhamma protects the one who lives by the Dhamma, the Dhamma well-practised is set on happiness,
esānuśaṃso dhamme sucinne na doggatiṃ gacchati dhammacārī ||	this is the advantage of the Dhamma well-practised, he who lives by the Dhamma does not go to a bad destination.
dhammo have rakkhati brahmacārī dhammo sucinno sukhāya dahāti |	The Dhamma protects the one who lives by the holy life, the Dhamma well-practised is set on happiness,
esā ’nuśaṃso dhamme sucinne na doggatiṃ gacchati brahmacārī ||	this is the advantage of the Dhamma well-practised, he who lives the holy life does not go to a bad destination.
acarittā brahmaceraṃ aladdhā yovvane dhanaṃ |	Not having lived the holy life, not having gained wealth in their youth,
jinnakroṃcā va jhāyaṃti jhīnamacche va pallare ||	they waste away like herons in a small lake devoid of fish.
śenti cāpādhikinno vā porāṇāni a ’nutthunaṃ ||	they lie like shafts scattered from a bow, wailing about things in the past.
ujjujjanti satīmanto na nikete ramaṃti te |	The mindful ones who are striving do not delight in a dwelling,
haṃsā va pallaraṃ hettā okam okaṃ jahaṃti te ||	like geese who abandon a lake, they abandon fondness for homes.
haṃsā va ādiccapathe vehāyasaṃ yānti iddhiyā |	As geese go through the path of the sky, they go through the sky by their power,
niyyāṃti dhīrā lokamhi mārasenaṃ pramaddiya ||	the wise are led out in the world, after crushing Māra and his army.
kin nu hāśo kim ānando niccaṃ prajjalite sati |	Why this laughter, why this joy, when the world is constantly burning,
andhakāramhi prakkhittā pradīpaṃ na gaveṣatha ||	when thrown into darkness, do you not seek for a light?
praccaṃtimaṃ vā nagaraṃ guttaṃ sāntarabāhiraṃ |	As a town in the border districts is guarded on the inside and the outside,
evaṃ rakkhatha āttānaṃ khaṇo vo mā upaccagū |	so one should protect oneself, and you should not let the moment pass,
na muṇḍabhāvā śamaṇo avrato alikaṃ bhaṇaṃ |	Not through being shaven is one an ascetic, if one lacks vows, speaks lies,
icchālobhasamāpanno śamaṇo kiṃ bhaviṣyati ||	and is endowed with greed and desire, how will one be an ascetic?
yo tu śameti pāpāni aṇutthūlāni sabbaśo |	The one who quenches wicked deeds, small and great, in every way—
śamaṇā eva pāpānāṃ śamaṇo ti pravuccati ||	through the appeasing of wicked deeds he is said to be an ascetic.
yassa chattrīśatiṃ sotā mānāphassamayā bhriśā |	For the one in whom thirty-six streams consisting of contact with conceit are strong,
vāhā vahanti dudriṣṭiṃ saṃkappā ggredhaniśśitā ||	the one with wrong view is carried off by the flow of his greedy intentions.
krodhaṃ jahe viprajaheya mānaṃ saṃyojanaṃ sabbam atikrameyā |	One should abandon anger, one should abandon conceit, one should overcome every fetter,
taṃ nāmarūpamhi asajjamānaṃ akiṃcanaṃ nānupatanti dukkhā ||	without clinging to mind and bodily form, sufferings never do befall the one having no possessions.
śaraṇavarggaḥ	The Chapter about Refuge
appakātemanuṣyesu ye janāpāragāmino |	Amongst humans few people go beyond,
athāyam itarā prajā tīram evānudhāvati ||	the rest of the people run down the bank,
ye ca kho saṃmadākkhāte dhamme dhaṃmānuvattino |	but those who live righteously, conforming with this well-taught Dhamma,
te janā pāram ehiṃti maccudheyaṃ suduttaraṃ ||	those folk will go beyond the realm of death, which is very hard to cross.
kihne dhamme viprahāya śukre bhāvetha paṇḍitā |	Having abandoned the dark state, the wise ones should develop the bright,
okā anokam āgaṃma viveko yattha dūramaṃ ||	having gone forth to homelessness from home; in solitude, where it is hard to delight,
tatthābhiratim eṣāṇā hettā kāme akiṃcanā |	one should seek to delight in that place, having given up sense pleasures, and having no possessions,
payirodametha āttānaṃ cittaṃ kileśehi sabbaśo ||	he should purify the self of defilements of mind in every way.
yassa saṃbodhiaṃgehi samaṃ cittaṃ subhāvitaṃ |	For he who has well developed with peaceful mind the factors of complete awakening,
āttānapaṭinissagge anupādāya ye ratā |	having given up the self, those who delight in being unattached,
khīṇāsavā jutīmanto te loke parinivṛtā ||	pollutant-free, shining forth, are emancipated in the world.
yadahi kiccaṃ tad apaviddhaṃ akiccaṃ puna kīrati |	That to be done is rejected, but what is not to be done is done,
unnaddhānāṃ pramattānāṃ tesaṃ vaddhaṃti āsavā ||	for the insolent, the heedless, their pollutants increase.
yesaṃ ca susamāraddhā niccaṃ kāyagatā satī |	But for those who always properly undertake mindfulness of the body
akiccaṃ te na sevaṃti kicce sātaccakāriṇo |	who do not practice what is not to be done, persisting in what is to be done,
satānāṃ samprajānānāṃ tesaṃ khīyaṃti āsavā ||	for those mindful ones, those fully aware, their pollutants are destroyed.
paravajjānupaśśīnāṃ niccaṃ ojjhāyasaṃñinā |	Those who look for others’ fault, who constantly perceive offence,
āsavā tesaṃ vaddhanti ārā te āsavakkhayā ||	for them the pollutants increase, they are far from their destruction.
jāgarikām anuyuttānāṃ ahorāttānuśikkhiṇāṃ |	For those devoted to being alert, who train both by day and by night,
nibbāṇe adhimuttānāṃ atthaṃ gacchaṃti āsavā ||	who are intent on Nibbāna, the pollutants are laid to rest.
yesā ’savā parikkhīṇā āhāre ca aniśśitā |	For those whose pollutants are destroyed, who are not dependent on the foods,
śuṃñatā ānimitto ca vimogho yesa gocaro |	for those whose resort is the liberation that is empty or signless,
na hi śīlavrateneva bāhuśoccena vā puna |	Not even through virtue or vows, or again through great learning,
atha vā samādhilābhena vivittaśayanena vā ||	or through the attainment of concentration, or through a secluded dwelling,
phusāma nekkhaṃmasukhaṃ apṛthujjanasevitaṃ |	do we attain the happiness of renunciation, not practised by worldly people;
bhikkhū viśśāsamāpādi aprāpyāsavakkhayaṃ ||	let a monastic not be confident as long as the destruction of the pollutants is unattained.
nāyaṃ pramajjituṃ kālo ’prāpyāsavakkhayaṃ |	This is not the time to be heedless, while the destruction of the pollutants is unattained,
pramattaṃ dukham anneti sīhaṃ vā mṛgamātikā |	heedless he follows suffering, like the mother of deer follows the lion.
gabbham eke okraṃmanti nirayaṃ pāpakaṃmuṇo |	Some fall back into the womb, but those who are wicked in the underworld,
saggaṃ sugatino yānti parinivvānti anāsavā ||	the righteous go to heaven, those who are pollutant-free are emancipated.
yathā hrado ’ssa gaṃbhīro viprasanno anāvilo |	Like a lake that is deep, clear and unruffled,
evaṃ dhaṃmāṇi śottāna viprasīdaṃti paṇḍitā ||	just so the wise are confident after listening to Dhamma.
yassa jitaṃ nā ’ppajjīyati jitam assā na upeti antako |	He whose victory cannot be undone, whose victory does not come to an end,
taṃ buddham anomanikramaṃ apadaṃ kena padena nehisi ||	the Buddha, the one of superior effort, by what path will you lead the pathless one?
yassa jālinī visattikā tahnā nāsti kahiṃ ci netaye |	For him there is no desire, attachment, or craving to lead him anywhere,
taṃ buddham anantagocaraṃ apadaṃ kena padena nehisi ||	the Buddha, whose range is endless, by what path will you lead the pathless one?
āsavavarggaḥ	The Chapter about the Pollutants
18. dadantī	18. The Chapter about Giving
dadantiveyathāśraddhaṃ yathāprasādanaṃ janā |	The people give according to faith, according to their confidence,
tattha yo duṃmano hoti paresaṃ pānabhojane |	herein the one who becomes depressed because of food and drink given to others,
na so divā ca rātto ca samādhim adhigacchati ||	does not, either by day or night, attain to good concentration.
yassa cetaṃ samucchinnaṃ mūlo ’gghaccaṃ samūhataṃ |	For the one in whom this depression is cut off, destroyed at the root, dug up,
sa ve divā ca rātto ca samādhim adhigacchati ||	does, by day and night, attain to good concentration.
aśśo va bhadro kaṣāya puṭṭho ātāpino saviṃgaṇo carāṇo |	Like a good horse touched by the whip, living ardent and spiritually intense.
śraddhāya sīlena ca vīriyeṇa ca samādhinā dhammavipaśśanāya ca |	Having faith, virtue and energy, concentration and insight into the Dhamma,
te khāntisoracchasamādhisaṃṭhitā śutassa praṃñāya ca sāram ajjhagū ||	well-established in patience, meekness and concentration, they have come to the essence of wisdom and learning.
yo driṣṭe dhaṃme labhati śraddhāṃ praṃñāṃ anuttarāṃ |	He who acquires faith and wisdom unsurpassed in this very life,
sa ve mahaddhano loke moham aṃñaṃ bahuṃ dhanaṃ ||	has great wealth in the world, other wealth, though great, is useless.
śraddho sīlena saṃpanno yaśabhogasamāhito |	The faithful one who is possessed of virtue, and has wealth and fame,
yaṃ yaṃ so bhajate deśaṃ tattha tattheva pūjiyo ||	whatever district he resorts to, right there and then he is worshipped.
śraddhābitiyaṃ puruṣaṃ carantaṃ na naṃ labheyā aśraddho va cāro |	Faith is a person’s travelling companion, he would not accept travelling without faith,
yaśo ca kittī ca tato nam eti saggaṃ ca gacche śarīraṃ prahāya ||	from that there will be fame and renown for him, and when he abandons the body he goes to heaven.
aśraddho akataṃñū ca saṃdhicchedo ca yo naro |	The person who is beyond mere faith, who knows that which is unmade, who has cut off rebirth-linking,
hatāvakāśo vāntāśo sa ve uttimaporuṣo ||	who has destroyed the occasion, who has thrown out hope and desire, is surely the person supreme.
kiccho buddhāna uppādo kicchā dhammassa deśanā |	It is rare the arising of Buddhas, rare the teaching of the Dhamma,
kiccho śraddhapaṭīlābho kicchaṃ māccāna jīvitaṃ ||	it is rare to acquire faith, rare is the life of mortals.
anavaṭṭhitacittassa saddhaṃmam avijānato |	For the one with unsettled mind, who does not know the True Dhamma,
pāriplavaprasādassa praṃñā na paripūrati ||	whose confidence is wavering, wisdom is unfulfilled.
nāprasannacittena duṣṭena kupitena vā |	For one who has a mind lacking confidence, that is base or agitated,
śakkam ājānituṃ dhammo sāraṃbhabahulena vā ||	and frequently impetuous, it is not possible to understand the Dhamma.
yo tu vinīya sāraṃbhaṃ aprasādaṃ ca cetaso |	He who has removed impetuosity, displeasure from his mind,
prasannacitto sumano sa ve nyāyyā subhāṣitaṃ ||	with confident mind, happy, he can understand well-spoken words.
manuṣyapaṭilābhena saggānāṃ gamanena ca |	Acquiring birth as a human, or going to the heavens,
pṛthivyām ekarājjena sotāpattiphalaṃ varaṃ ||	or having sole sovereignty over the earth—better is the fruit of stream-entry.
yassa śraddhā tathāgate acalā supratiṣṭhitā |	He whose faith in the Realised One is well-established and unmoveable,
śīlañ ca yassa kallāṇaṃ ayirakāntaṃ praśaṃsiyaṃ ||	whose virtue is beautiful, praised by the noble ones,
saṃghe prasādo yassa asti ujjubhūtañ ca daṃśanaṃ |	who has confidence in the Saṅgha, who sees uprightly,
adaridro ti tam āhu amoghaṃ tassa jīvitaṃ ||	he they say is ‘not poor’, his life is not in vain.
tassā śraddhañ ca śīlaṃ ca prasādaṃ dhammadaṃśane |	Therefore with faith, virtue, confidence and insight into Dhamma,
anuyuñjeya medhāvī saraṃ buddhāna śāsanaṃ ||	a sage should devote himself to the essence of the Buddhas’ dispensation.
dadantīvarggaḥ	The Chapter about Giving
caranti bālā dummedhā amitteṇa-r-iva āttanā |	Stupid fools live having themselves as their own foes,
karontā pāpakaṃ kammaṃ yaṃ hoti kaṭukapphalaṃ ||	committing wicked deeds, which produce bitter fruit.
kathañ ca taṃ kare kaṃmaṃ yaṃ kattā anutappati |	How could he do that deed, which, having done, one has regret,
yassa aṃśumukho rodaṃ vipākaṃ paṭisevati ||	for which he has tears on his face, as the result follows him round.
taṃ ca kaṃmaṃ kataṃ sādhu yaṃ kattā nānutappati |	But that deed is well done, which, having done, one has no regret,
yassa pratīto sumano vipākaṃ paṭisevati ||	for which he is pleased and happy, as the result follows him round.
yāvad eva anatthāya ñāttaṃ bālassa jāyati |	As far as learning arises for a fool, it is only to his disadvantage,
hanti bālassa śukrāṅggaṃ (?) muddham assa nipātaye ||	it destroys the fool’s good quality, and it will destroy his head.
asatāṃ bhāvanam icchanti purekkhārañ ca bhikkhusu |	He wishes for the respect that is lacking, and status amongst the monastics,
āvāsesu ca essariyaṃ pūjāṃ parakulesu ca ||	for control in the living quarters, and worship amongst good families:
mameva katamannentu gṛhī pravrajitā ca ye |	“Householders and renunciants should think this was done by me,
na me pratibalā assa kiccā ’kiccesu kesuci ||	let none be a match for me, in all to be done and not done”,
iti bālassa saṃkappo icchāmāno ca vaddhati |	so does the fool think, meanwhile his desires and conceit increase.
aṃñā hi lābhopaniśā aṃñā nibbāṇagāminī ||	For the means to gains is one thing, the path going to Nibbāna another,
evam etaṃ yathābhūtaṃ paśśaṃ buddhassa sāvako |	thus seeing this as it really is the disciple of the Buddha
sakkāraṃ nābhinandeyā vivekam anubrūhaye ||	should not delight in honours, but practise in solitude.
jayaṃ ve manyate bālo vācāya paruṣaṃ bhaṇaṃ |	The fool thinks there is success, when he speaks words that are rough,
satāṃ hesa jayo hoti yā titikkhā vijānato ||	but for the one who knows, endurance is the success of the good.
abalaṃ tassa balaṃ hoti yassa bālabalaṃ balaṃ |	Without power is the power of him whose power is the power of a fool,
balassa dhammaguttassa paṭivattā na vijjati ||	reproach is not found for the powerful one, protected by Dhamma.
yo bālo bālamānī paṇḍito cāpi tattha so |	The fool who conceives he is a fool, is at least wise in that matter,
bālo tu paṇḍitamānī sa ve bālo ti vuccati ||	the fool who is proud of his wisdom, he is said to be a fool indeed.
drīghā assupato rātrī drīghaṃ śāntassa yojanaṃ |	Long is the night for one who sleeps not, long is a league for one tired,
drīgho bālānā saṃsāro saddhaṃmam avijānatāṃ ||	long is the round of births and deaths for fools who know not True Dhamma.
pūtimacche kuśāggreṇa yo naro upanahyati |	That man who wraps up rotting fish with the best fragrant grass,
kuśā pi pūtiṃ vāyanti evaṃ bālopasevanā ||	makes the fragrant grass smell rotten, and so with those who associate with fools.
tagarañ ca palāśamhi yo naro upanahyati |	That man who wraps up pinwheel in flame-tree leaves,
pattaṃ pi surabhiṃ vāti evaṃ dhīropasevanā ||	makes even the leaf fragrant, and so with those who associate with the wise.
akaronto pi ce pāpaṃ karonte upasevati |	If one who does no wickedness associates with those who do,
śaṅkiyo hoti pāpamhi avaṇṇo cāssa rūhati ||	he is suspected of wickedness, and his disrepute increases.
sevamāno sevamāne saṃpuṭṭho saṃphusaṃ pare |	An associate associating with others who are touched by contacts,
śaro litto kalāpe vā alitte upaliṃpati |	like a smeared arrow in a bunch, smears that which is unsmeared,
upalepabhayā dhīro neva pāpasakhā siyā ||	fearing being smeared the wise one will not have wicked friends.
tassā phalapuṭasseva ñāyyā saṃpākam āttano |	Therefore knowing the result for oneself of the fruit container,
asanto nopaseveyā santo seveya paṇḍito ||	he should not follow the bad one, the wise one should associate with the good one.
yāvaj jīvaṃ pi ce bālo paṇḍite payirupāsati |	Even if a fool attends on a wise man for his whole life long,
neva dhammaṃ vijānāti dravvī sūparasān iva ||	he does not learn Dhamma, like the spoon learns not the taste of curry.
muhuttam api ce praṃño paṇḍite payirupāsati |	If a perceptive man attends on a wise man even for a second,
khipraṃ dhammaṃ vijānāti jivhā sūparasān iva ||	he quickly learns Dhamma, like the tongue learns the taste of curry.
nāppaṃ pāpassa maṃñeyā na me taṃ āgamiṣyati |	One should not despise a little wickedness thinking: it will not come to me,
udabindunipātena udakuṃbho pi pūrati ||	through the falling of water drops the water-pot is quickly filled,
pūrate bālo pāpassa thokathokaṃ pi ācinaṃ |	the fool, gathering bit by bit, becomes full of wickedness.
nāppaṃ puṃñassa manyeyā na me taṃ āgamiṣyati ||	One should not despise little merit thinking: it will not come to me,
pūrate praṃño puṃñassa thokathokaṃ pi ācinaṃ ||	the wise one, gathering bit by bit, becomes full of merit.
bālavarggaḥ	The Chapter about Fools
khāntī paramaṃ tapo titikkhā nibbāṇaṃ paramaṃ vadanti buddhā |	Enduring patience is the supreme austerity, Nibbāna is supreme say the Buddhas,
na hi pravrajito paropaghātī śamaṇo hoti pare vihesayāno ||	for one gone forth does not hurt another, nor does an ascetic harass another.
ahiṃsakā ye munayo niccaṃ kāyena saṃvṛtā |	Those sages without violence, constantly restrained in body,
te yānti accutaṃ ṭṭhāṇaṃ yattha gantā na śocati ||	go to the deathless Nibbāna, having gone there they do not grieve.
suprabuddhaṃ prabujjhanti sadā gotamasāvakā |	Gotama’s disciples always awake to a good wakening,
yesāṃ divā ca rātto ca ahiṃsāya rato mano ||	those who day and night have a mind that delights in non-violence.
yesāṃ divā ca rātto ca bhāvanāya rato mano ||	those who day and night have a mind that delights in cultivation.
yesāṃ divā ca rātto ca niccaṃ kāyagatā satī ||	those who day and night constantly have mindfulness of the body.
ye jhānaprasutā dhīrā nekkhaṃmo ’paśame ratā |	Those wise ones intent on meditation, who delight in the peace of renunciation,
devā pi tesaṃ prihayanti saṃbuddhānāṃ satīmatāṃ ||	even the gods are envious of them, the Sambuddhas, the ones who are mindful.
aranne yadi vā ggrāme ninne vā yadi vā thale |	Whether in the wilds or village, whether on low or on high ground,
yattha arahanto viharaṃti taṃ bhomaṃ rāmaṇīyakaṃ ||	wherever the Arahats live, that ground is surely delightful.
ekaṃ pi ce prāṇam aduṣṭacitto mettāyate kuśalī tena hoti |	If, for even one living being, one with an uncorrupt mind, has loving-kindness, there is wholesomeness in that,
sabbe ca prāṇe manasā ’nukaṃpī prabhūtam ayiro prakaroti puṃñaṃ ||	but the one with compassion in mind for all living beings, that noble one makes abundant merit.
ye sattaśaṇḍāṃ paṭhaviṃ vijettā rājariṣayo yajamānā ’nupariyagu |	Those who conquered the earth, crowded with beings, those royal seers who went round sacrificing:
aśśamedhaṃ puruṣamedhaṃ saṃmaprāsaṃ vāyupeyaṃ nirāggaḍaṃ |	the horse sacrifice, the man sacrifice, the stick-casting, the soma offering, the unobstructed—
mettassa cittassa subhāvitassa kalāṃ pi te nānubhavanti soḍaśiṃ |	compared to the one who develops his mind with loving-kindness, they do not partake of even a sixteenth part,
candaprabhāṃ tāragaṇā va sabbe ||	just as the whole host of stars do not partake of the radiance of the moon.
yo ’tha metteṇa cittena sabbe prāṇe nukaṃpati |	Then he who with a mind of loving-kindness has compassion for all living beings,
mettaṃ se sabbabhūtesu veraṃ tassa na kenaci ||	having loving-kindness towards all beings, he has no one who is hated.
yassa sabbe ahorātte ahiṃsāya rato mano |	For he who every day and night delights in a mind of non-violence,
yassa sabbe ahorātte bhāvanāya rato mano |	For he who every day and night has a mind that delights in cultivation,
yassa sabbe ahorātte niccaṃ kāyagatā satī |	For he who every day and night constantly has mindfulness of the body,
yo na hanti na ghāteti na jināti na jāpaye |	He who neither kills, nor has killed, conquers, nor has conquered,
na hi vereṇa verāṇi śāmantīha kadācanaṃ |	For not by hatred do hatreds cease at any time in this place,
avereṇa tu śāmaṃti esa dhaṃmo sanātano ||	they only cease with non-hatred, this truth is surely eternal.
pare ca na vijānaṃti vayam ettha jayāmatha |	The others do not understand that we should be successful here,
ye ca tattha vijānaṃti tato śāṃmaṃti medhakā ||	but for those here who do understand, through that, their dissensions do cease.
susukhaṃ vata jīvāmo veriṇesu averiṇo |	Let us live truly happily, without hatred, amongst those who have hatred,
veriṇesu manuṣyesu viharāma averiṇo ||	amongst humans who have hatred let us live without hatred.
susukhaṃ vata jīvāmo ussukesu anussukā |	Let us live truly happily, without longing, amongst those who are longing,
ussukesu manuṣyesu viharāma anussukā |	amongst humans who are longing let us live without longing.
susukhaṃ vata jīvāmo yesaṃ no nāsti kiṃcanaṃ |	We live truly happily enough having no possessions ourselves,
sakiñcanesu manuṣyesu viharāma akiṃcanā ||	amongst those with possessions let us live having no possessions.
yathā bubbudakaṃ paśśe yathā paśśe marīcikaṃ |	One should see it as a bubble, one should see it as a mirage,
evaṃ lokaṃ avecchānam maccurājā na paśśati ||	looking on the world in this way the King of Death does not see one.
parijinnam idaṃ rūpaṃ roganīḍaṃ prabhaṃguraṃ |	This body is worn out, a nest of disease, perishing,
bhijjīhiti pūtisaṃdeho maraṇāttaṃ hi jīvitaṃ ||	the putrid body comes to destruction, for life ends in death.
jihmaṃ ca driṣṭā dukhitaṃ ca vyādhitaṃ pretañ ca driṣṭā na cirassa mānavo |	Having seen an old man, one afflicted and sick, having seen one deceased, after not long for the student,
saṃvego tīppe (?) vipulo (?) ajāyatha acchecchi dhīro gṛhibandhanāni ||	anxiety, sharp and extensive, arose, and the wise one cut the household bonds.
khāntivarggaḥ	The Chapter about Patience
asajjhāyamalāvedā anuṭṭhāṇamalā gharā |	Lack of repetition is the ruin of the Vedā, a lack of maintenance is the ruin of homes,
malo vaṇṇassa kosajjaṃ pramādo rakkhatāṃ malo ||	indolence is the ruin of one’s appearance, heedlessness is the ruin of those on guard.
malo istiye duccaritaṃ maccheraṃ dadatāṃ malo |	Bad conduct is a woman’s stain, stinginess is a giver’s stain,
malo pāpāni kaṃmāṇi assiṃ loke paramhi ca ||	wicked deeds are a stain both in this world and in the next.
tato malataraṃ brūmi avijjā maraṇaṃ malaṃ |	I say there is a stain worse than that, ignorance is a deadly stain,
ete male prahattāna niṃmalā caratha bhikkhavo ||	after abandoning those stains, live without stains, monastics!
ayasā tu malo samuṭṭhito tato uṭṭhāya tam eva khādati |	As a rust stain arises from iron, and arisen from that, it eats it away,
em eva vidhūnacāriyaṃ sakāni kaṃmāṇi nayanti doggatiṃ ||	so with one who is overindulgent—his deeds lead him to a bad destiny.
pāṇḍupalāśo ca dāni si yamapuruṣā pi ca te upaṭṭhitā |	You are now a withered leaf, Yama’s men stand waiting for you,
uyyogamukhe ca tiṣṭhasi pātheyaṃ pi ca te na vijjati ||	you stand at decay’s door, with no provisions for the journey found.
uyyamassa ghaṭassa āttanā kaṃmāro rajataṃ va niddhame |	You should strive and endeavour by yourself, like a smith, you should remove the stain,
niddhāntamalo anaṅgano bitiyaṃ ariyabhūmim esi ||	removing the stain, blemishless, you seek the second noble realm.
anupūrvveṇa medhāvī thokathokaṃ khaṇe khaṇe |	The sage gradually, little by little, moment by moment,
kammāro rajatasseva niddhame malam āttano ||	should remove the stain from himself, like a smith removes the stain from silver.
sujīvaṃ ahirīkena saṃkiliṣṭan tu jīvati |	Life is light for one without shame, he lives a life with defilements,
prakkhaṇḍinā pragabbheṇa kākaśūreṇa dhansinā ||	backbiting and recklessness, with the bold courage of a crow.
hirīmatā tu dujjīvaṃ niccaṃ śucigaveṣiṇā |	Life is hard when endowed with shame, for the one constantly seeking purity,
alīnenāpragabbheṇa śuddhājīvena paśśatā ||	for one sincere, and not reckless, looking for purity of life.
supaśśaṃ vajjaṃ aṃñesaṃ āttano puna duddaśaṃ |	Easy to see are others’ fault, but one’s own is hard to see,
paresām iha vajjāni uppunāti yathā busaṃ |	for one sifts other peoples’ faults like they were chaff,
āttano puna chādeti kalim va kṛtavāṃ śaṭho ||	but conceals one’s own faults, like a crafty player conceals his defeat.
sukarāṇi asādhūni āttano ahitāni ca |	Easily done are things not good, and unbeneficial for oneself,
yaṃ ve hitaṃ ca sādhuñ ca taṃ ve paramadukkaraṃ ||	but that which is beneficial and good is supremely hard to do.
yāni hitāni sādhūni tāni kurvvanti paṇḍitā ||	but only those beneficial and good are done by the wise.
alajjitavve lajjanti lajjitavve na lajjatha |	They are ashamed of what is not shameful, not ashamed of what is shameful,
abhaye bhayadaṃśāvī bhaye cābhayadaṃśino |	seeing fear in what is not fearful, not seeing fear in what is fearful,
micchadṛṣṭisamādānā sattā gacchanti doggatiṃ ||	undertaking wrong views, beings go to a bad destiny.
avajje vajjamatino vajje cāvajjasaṃñino |	Finding blame in what is blameless, not perceiving blame in what is blameable,
asāre sāramatino sāre cā ’sārasaṃñino |	Finding the essential in the unessential, and perceiving the unessential in the essential,
te sāran nādhigacchanti micchasaṃkappagocarā ||	they do not understand what is the essential, and resort to wrong intention.
sārañ ca sārato ññāttā asārañ ca asārato |	Knowing the essential in what is essential, and the unessential in what is unessential,
te sāram adhigacchanti saṃmasaṃkappagocarā ||	they understand what is essential, and resort to right intention.
ayoge yuñjiyāttānaṃ yogamhi ca ayuṃjiya |	Engaging oneself in what is not suitable, not engaging in what is suitable,
atthaṃ hettā priyaggrāhī pṛhayantatthānuyogināṃ ||	abandoning the good, grasping the loved, they envy those who endeavour for good.
malavarggaḥ	The Chapter about Stains
